fluidify	积满液体
yha	青年招待所协会
povera	概念派的
ingravescence	逐渐加重
groom	修饰
pytheas	皮西亚斯
belgique	=Belgium
rue	懊悔
funnyman	喜剧演员
massify	一体化
isotactic	全规的
choir	唱诗班
lather	紧张
gratulatory	祝贺
letterer	文字雕刻员
colubrine	蛇
lubricious	淫荡
phrenologic	骨相学
humble	微贱
panhandle	锅柄
rodriguan	罗得里格斯岛
autoptical	实地考察的
enforceable	可强迫
prominence	突出
unbelievably	不可信
briefly	暂时
revolt	反叛
ruche	褶带
vibration	振动
workout	测验
hashimite	哈桑王族
remunerate	酬劳
activating	使活动
hobber	在靴上钉平头钉的工人
totality	总数
slack	懒散的
kilometre	公里
weak	弱的
caoutchouc	弹性橡皮
pakistani	巴基斯坦人
lax	松懈的
rheotactic	微生物在水流中之行动
whole	未打破的
reticulation	网状物
carmot	构成点金石的原料
villainous	恶棍
sax	XML
helispherical	在球体上成螺旋状缠绕的
supernatural	超自然
eucaryote	真核生物
preproduction	预制造的
prebiological	=prebiotic
unambivalent	鲜明的
costful	珍贵的
teen	愤怒
sociocultural	社会与文代化
dramatize	改编成为戏剧
slade	Lithographic
doltish	呆笨的
shellproof	防弹
sheriffdom	职务等
methylene	亚甲基
serodifferentiation	血清鉴别
tell	讲述
extrorse	向轴外
mutinous	反抗
phenylbenzene	联
prothesis	圣餐台
yawata	现为北九州市
tintack	镀锡的大头钉
consanguinity	血亲
disanimation	失去生命
destructively	狼狈
eject	驱逐
lomentaceous	节荚状
humorously	幽默地
fissilingual	舌头裂开的
injectable	可注射的
monobloc	整体的
feignedly	假装地
globulous	球状的
speculum	诊视器
amphibia	两栖纲
nuclease	核酸酶
potent	有力的
secularization	凡俗化
regenerate	重建
duodecimal	十二分算
simulative	模拟
felting	毛毯类
morosely	愁眉苦脸地
repulsive	推斥
personal	私人
repossess	复
turmeric	姜黄根粉末
interpretable	能翻译的
supporter	支持者
bream	铜盆鱼类
distichously	二分地
mammogen	激乳腺素
weatherboarding	装以护墙板
chironomid	摇蚊
isobarically	恒压的
truehearted	忠实
phlyctenule	小水疱
brace	振作精神
festoonery	花彩装饰
erewhile	片刻前
roscian	像罗西乌斯
welsh	食言
lavage	灌洗
peristylium	周柱中庭
lobstering	捉龙虾
soho	来阿!
oread	俄瑞阿
raa	英国皇家艺术院
remote	偏僻
resinoid	树脂状的
disposed	有……倾向的
mamillate	有乳头的
doomwatcher	观望末日的人
brooky	河道纵横
beery	象啤酒
microspore	小孢子
youngstown	扬斯敦
psittaceous	鹦鹉般
tropolone	环庚三烯酚酮
delineator	描写用器具
terrier	地籍册
homodont	同型齿的
partridgeberry	蔓虎刺之类
hinterland	穷乡僻壤
section	部分
mhr	the
phosphoric	磷的
waxen	似蜡
priss	娇女孩
indebt	使受恩惠
sericterium	丝腺
luteinize	使成为黄体部份
bitterly	厉害
sodomite	鸡奸者
voter	选举人
cherub	胖娃娃
preconquest	诺曼人征服英国前
kunlun	Mountains昆仑山
canaliculated	有小沟的
niton	氡
unjelled	不固定
modernism	现代风
effectuation	完成
tokoloshe	托科洛希
changeably	不稳定
munich	慕尼黑
wet	潮湿的
morose	乖僻
landgravine	女伯爵
suicidal	自杀的
ultramontane	山那边的
infinite	无限
telltale	搬弄是非
specialize	专门研究
unjoint	拆开连结处
lwop	leave
tannic	得自鞣革的
southmost	最南
conqueringly	耀武扬威地
kicker	踢者
seawards	向海
sue	请愿
antasthmatic	治疗气喘
incessancy	持续不断
unprepare	使无准备
tuxedo	男士无尾半正式晚礼服
mccarthyist	麦卡锡主义者
clarifier	澄清器
agonising	烦恼
collectivistic	集体主义
ruttish	春情的
iso	Standardization
reconcilable	可调和
airpark	小飞机场
isdn	Services
muffler	消声器
virogenic	病毒原的
disconcert	使惊惶
fordone	筋疲力尽的
expansion	浩瀚
unluckily	偏巧
pacification	和解
impeditive	妨碍
booze	酒宴
puritanical	严格的
moulder	分裂
glandular	腺的
capriole	跃起
phase	相位
decoloration	去色
lachlan	拉克兰河
gallionic	不问事的
diplogen	氘
entophytic	内生植物的
laguna	小池
insolvency	破产
subgroup	小群
micrometeor	=micrometeoroid
askew	歪斜地
cerebral	大脑的
thermic	热的
chillness	寒冷
healing	复原
sunkist	受阳光照射的
cellularized	分裂为很多细胞
run	逃跑
gladness	欢喜
vagrant	漂泊的
corroboratory	确定
bronchitic	支气管炎的
blowzy	不整洁
universally	普遍
flirtatious	爱调戏的
plush	长毛绒做
interrelation	相互关系
aureate	镀金的
paint	涂料
shirt	衬衣
ghostlike	恐怖
lipopectic	脂肪固定的
magnify	扩大
kempt	整洁
aerobiological	大气生CdVIkLlI/
phrasemonger	爱用华丽词句的人
unmatched	无匹敌的
interruption	打断
magnesic	含镁
actiyator	调速控制器
etruria	埃特鲁斯坎
samarang	=Semarang
ergotin	麦角精
memoirist	回忆录
dirty	恶劣
fac	air
assiduity	一丝不苟的作风
declivitous	相当陡的
unseen	看不见
una	联合国协会
imperturbable	冷静的
cytoplast	胞质
clannishly	派系
chinnampo	镇南浦(朝鲜民主主义人民共和国西部港市南浦
shilingi	坦桑尼亚先令
sterile	不结果
bms	海洋科学学士
semidurables	半耐用品
malodorant	=malodorous
still	静寂
instant	速溶
volatilizable	可挥发
platyrrhine	阔鼻类
synonymist	同义词汇编者
semidetached	只有一边相衔接的
honeybunch	亲爱的
sporangia	sporangium的复数
chield	家伙
unfrequent	不常发生的
bravissimo	太好了!好极啦!
hieroglyphologist	象形文字学/y/9haIErE^lI`fClEdVI/
sublime	提高
infelicific	招致不幸的
shade	遮蔽
toric	环面的
jesuitically	耶稣会地
trash	废物
facility	灵巧
foursquare	直爽的
crankily	暴躁
floral	植物群
vitellin	蛋黄素
kymography	记波照相术
dodecahedral	十二面体
belletristic	纯文学
unprofitable	不赚钱
cdma2000	Code
tenement	房屋
olimbos	奥林匹斯山
fade	褪色
photochromy	彩色照相术
warrior	鼓吹战争的人
frequently	经常地
throat	咽喉
roscian	像罗西乌斯的
mephitic	恶臭
hasty	草率
autolyze	自体溶解
junkyard	废旧物堆积
munitioner	军火商
microgamete	小配子
ratheripe	早熟
pentathlete	五项全能运动员
amenable	有服从义务
tatty	破旧
episcopature	主教之权限
calyculate	有杯状小体的
watchmaking	制表业
considerately	体贴
radiotransparent	在X光照射中不显影的
devouringly	贪食地
piemonte	皮埃蒙特区
abherent	追随者
puristic	修辞癖的
hoverheight	悬浮高度
delicate	病弱
orbicular	圆满
kitchensink	刻划现代生活不光明的一面
birdman	飞行员
marrowsky	首音互换
barren	不生育的
benedictional	使人幸福的
armory	兵工厂
simpleminded	纯朴
biramose	具二枝
lordotic	脊柱前凸的
vb	Basic
lyonnaise	用洋葱作配菜烧成
undissembling	公开
qnp	pawn
radioisotope	放射性同位元素
psychiater	精神病医师
hesperides	守护金苹果树的仙女
greasy	多脂的
riddling	谜一样
tailgunning	机尾枪的
cockeyed	傻
margery	女子名
sex	性欲
admirer	敬慕者
anticancer	抗癌
currier	制革匠
ruddiness	红色
unembroidered	未加修饰
unchoke	清除……的障碍
histomap	历史地图
dotty	多点
allheal	万灵草药
aminate	氨化
calculous	结石症
whiten	漂白
ingenital	内在的
chemotactically	趋化现象地
upset	扰乱
racemiferous	有串状花的
tail	船尾搁浅
dolomitic	含白云石
sterilize	消毒
vignette	装饰图案
prosciutto	意大利熏火腿
hydropsychotherapy	精神病水疗法
spitzbergen	=Spitsbergen
cyaneous	深蓝色
meretricious	俗气的
disremembrance	忘记
moksa	从轮回中得到解脱
traipse	拖曳
endoglobular	在血球内发生
ascending	向上的
preciously	昂贵地
polynuclear	多核的
trivialism	琐碎
phi	希腊文的第
impious	无信仰的
curvy	曲线美
guana	巨蜥
valetudinarian	体槿醯
sill	门槛
labyrinth	迷宫
paradrop	利用降落伞空投
courtliness	礼让
watcher	观察者
mace	催泪瓦斯
nylex	耐勒克斯
gibbose	凸状的
sympathizer	同意者
affectivity	情感性
karroo	南非洲的干燥台地高原
unplucked	未拔毛的
schoolchild	学童
subterconscious	=subconscious
simple	天真的
conradian	有康拉德特色的
tass	Union
endogenesis	内生
shrewish	脾气暴躁的的
ardently	热烈地
etep	Efficiency
scarfskin	外皮
sonance	声音
compulsory	被强迫的
sparkling	闪闪发光的
provascular	原形成层
unphysiological	生理上不健全的
ayh	American
matey	好朋友
mesencephalon	中脑
isospondylous	等椎目
footway	小路
rummy	危险
maestro	艺术大师
discoverer	发现者
crinite	有毛发的
chalklike	似粉笔的
tractable	易驾驭的
mindanao	棉兰老岛
fiance	未婚夫
bimonthly	双月刊
pantisocracy	大同世界乌托邦
elektron	=electron
alpenstock	登山杖
unprizable	不值得评价
nourice	=nurse
kicker	爱踢的马
cannikin	木桶
basaltic	玄武岩的
narcose	昏睡的
asteraceous	紫菀科
delian	l
observingly	注意地
sedentariness	定居
rockbound	顽固的
tailorship	成衣活
consociation	合作
embroidery	粉饰
legend	联想集团
page	标明……的页数
migraineur	偏头痛患者
triskelion	三曲臂图
hematopoietic	造血的
haunted	受到折磨
countercharge	反攻
haily	夹有冰雹
sulfonylurea	=sulphonylurea
sib	近亲
thermic	热
repeal	否定
weekend	周末休假
gaper	打哈欠的人
unrenewable	无法再用的
vintage	最佳
kithe	公布
workman	工人
anoopsia	上斜视
nail	钉
gcf	common
wintertime	冬
seducer	骗子
qualification	资格
unseemly	不体面地
exsuccous	无汁的
haj	麦加朝圣
winning	获
ontogenic	=ontogenetic
evangelistically	福音传教士
hypoptyalism	泌涎不足
subnuclear	亚核粒子研究
peasant	乡下人
clergy	圣职者
flavorous	美味
magcard	磁卡
encephalitogen	致脑炎病毒
scuttle	舱室小孔
smooth	圆滑的
pogamoggan	大头棒
feep	发出尖笛声
aftereffect	后果
wog	疾病
undefendable	不能保卫的
evolutive	演变
lg	Low
cot	帆布床
liveweight	活重
harpsichord	大键琴
yom	日子
equipotential	等电位
donable	可赠与的
obviate	消除
fabulize	编造寓言
sopot	索波特
classically	拟古地
matronly	主妇似
applicable	可适用的
graveness	严重
doggery	下等社会
disconnected	分离
impugn	打击
coeval	同时代的
exhilarative	使高兴的
deprecation	强烈不赞成
prevalent	流行
husky	谷的
securely	安心
unconcernedly	不在乎
parathormone	甲状旁腺素
book	工作簿
citramontane	山这边的
sling	钩悬带
prix	价格
ceterach	一种羊齿植物
reen	排水沟
pickoff	以牵制球使出局
foraminiferous	有孔虫目
radiomimetic	类放射的
coldhearted	冷淡无情的
smooth	变平静
victualing	粮食获取
sensation	感动
southeastward	东南
artifactitious	加工
ulf	Ultra
easygoing	悠闲
unhuman	无人类属性的
incisive	尖锐的
erotologist	色情文学家
exotic	奇异的
miscreance	错误信仰
ainu	阿伊努人
monsoon	季风
ambiguous	暧昧的
crooknecked	颈部弯曲
napooed	结束
restiform	绳状
tastefully	高雅地
playdate	上映期
sideline	兼职
stuffy	乏味
histioid	蜘蛛网状的
urinose	尿质
interested	有权益的
trotty	小跑
beard	胡须
eunomic	良好的
blandish	讨好
moorish	摩尔人式的
ramark	雷达指点标
septangle	七边形
tongued	说话……
haematologist	血液学学者
nearshore	近岸水域
masticable	可咀嚼
amaranthine	不死
windows	微软公司生产的"视窗"操作系统
disapprobation	非难
offset	弥补
smoky	烟状
landler	兰德勒舞
linguistry	语言学知识
mean	低劣
unadaptable	不能适应
topgallant	最高的
crassilingual	有厚舌
unsympathizing	不同情
chimeric	妄想
hirable	能雇用的
opencast	露天挖掘
quechuan	盖丘亚人的
inaptly	不合宜
antipyretic	退热的
determining	决定
agoraphobe	旷野恐怖症
rival	对抗
cambium	形成层
cleavable	劈得开的
finitism	有限论
cajolery	甜言蜜语
tab	帐单
tempestuous	有暴风雨的
photorecorder	自动记录照相机
fluoridate	在饮水中加少量之氟
colourplate	彩色版
pinto	花马
pedicle	=pedicel
gadid	鳕科的
channel	形成河道
whinstone	玄武岩类
maulvi	大毛拉
dilate	详述
sinicism	中国习俗
noncommissioned	无委任令的
jurat	地方法官
foreoath	讼前宣誓
oracle	美国ORACLE公司
hubless	无轮毂的
smoothly	平稳地
coeval	同时代的人
hymenopter	膜翅目昆虫
sylvicultural	造林的
kiaugh	烦心
renunciate	宣布中止
plenty	大量
dropshutter	自动下落防光门
celoscope	腹腔镜
liveability	=livability
chemist	药剂师
aforehand	预先的
significance	重要性
quadrumane	四足构造皆如手的脊椎动物
intermediary	仲裁者
fatter	丰满
bacteroid	细菌状的
coolville	顶呱呱
quoit	绳圈
coeternal	同为永远的
theirs	他们
centromere	着丝粒
sectile	可切的
with	用
unwashed	不清洁
subtemperate	亚温带的
quid	二十先令
tetraparesis	四肢轻瘫
amphitryon	底比斯王
somnambulant	梦游的
silvanus	森林田野之神
chromatophil	易染色性
avulsed	被撕开
homogenization	纯一化
unbeknown	未知的
alulae	的复数形式
wizard	巫术
neuropter	脉翅目昆虫
electropolar	电极化
peer	与……同等
bachelor	单身汉
ashore	向岸地
zodiacal	黄道带内
cytrel	"赛特雷尔"代烟丝
piercingly	刺透地
permeable	有浸透性
gradatim	渐渐地
weariful	使人疲倦的
simpleness	简单
spadicose	生肉穗花序的
chimeric	妄想的
nga	Association
assaying	分析试验
odditional	补充
glacis	斜堤
fijian	斐济群岛语
utricle	胞果
inimitable	独特
patriarchy	父权制
macroscopic	肉眼可见
gametocide	杀配子剂
manumission	解放
punic	古迦太基人
cenobitism	修道院制
maculate	玷污
sticker	滞销物
disloyalty	不信
ferriferous	含有三价铁
hamza	代表闭锁音的符号的
phoning	打电话给
calendula	金盏草
disgustful	唾弃的使人发呕
depreciation	折旧
adipokinetic	hormone脂肪动员激素
flirtatious	爱调戏
mesovarium	卵巢系膜
piffling	琐碎
fill	注满
vacuumize	真空包装
cadet	拉皮条的人
humanly	像人地
aomori	青森
bundesrath	瑞士联邦议会
esr	electron
preadolescence	青春期前
triniscope	三枪显像管
hornwork	角器
griffith	格里菲思
fortification	防御工事
ultimate	最后
fair	美好的事物
mystagogic	传授秘诀的
myxovirus	黏病毒
riffy	多连复段的
liquefaction	液化
biramose	二枝
sicative	收湿
polonius	波洛尼厄斯
unreasoningly	不合理地
phenate	石炭酸盐
saccate	有囊
unisonous	同度
uddered	有乳腺的
notarise	=notarize
prepositor	学生自治会主席
graf	伯爵
malayan	马来人的
adrenalin	肾上腺素
anchithere	化石马
health	健康状态
lallygag	性交
lurcher	间谍
shortfall	不足量
sweeping	扫荡
adrenergic	释放肾上腺素
straight	直的
hydrated	含水
phlogosis	炎症
jazz	游荡
greasiness	多脂
montefiascone	蒙蒂菲阿斯科尼白葡萄酒
inorganizable	无法组织的
earnest	认真
subdeaconate	副执事职位
sweeping	扫荡的
accessible	易接近
parthenos	处女
unpin	拔掉闩
dilatorily	慢吞吞
niblick	铁头球杆之一种
longevity	供职期限
period	过去某段时期的
fasching	谢肉节
wearable	可穿用的
misgotten	不正当获
tubercule	瘤状突起
combing	梳弃的毛或发
catalogue	目录
transvestism	易装癖
guarani	瓜拉尼语
encephalic	脑
motivity	动力
inform	告诉
kuibyshev	古比雪夫
start	优先地位
sailor	不大会晕船的人
dogfight	缠斗
hercules	武仙座
vespine	大胡蜂的
lallan	苏格兰低
deglaciation	冰川的消失
cqd	come
undissolute	不放纵的
saccharometer	较酵计
dysaesthesia	感觉迟钝
enlarger	增补者
mitsein	共在
catfoot	轻声地走
arrester	捕拿者
equinoctial	赤道
activation	活化作用
aposematic	警戒色的
synclinal	向斜层
vaporescence	汽化过程
octangle	八角形
sociocultural	社会与文代化的
trigamous	雌雄三种花的
queenly	威严
aclinic	水平
iaaf	国际业余田径联合会
depreter	墙壁的碎石面饰
stracciatella	鸡蛋干酪汤
ungovernable	难统治
decennium	十年间
summit	参加最高级会议
ruijin	瑞金
intertype	国际牌行式排字机
mitigant	缓和的
yeh	是
help	治疗
aton	阿托恩
allpowerful	全能的
flashily	瞬间
matins	英国教堂之晨祷
wlm	妇女解放运动
laurustinus	棉毛荚莱
exotoxic	外泌毒的
ruler	统治者
scantling	少量
glyconic	格莱坎诗体
provide	预防
loop	以环连结
collarette	女用围巾
epicalyx	萼状总苞
deplethoric	贫血
consenting	同意
floating	不固定
hurriedly	仓促地
unalleviated	未减轻
collogue	密议
adularescent	有白色
unsensible	无知觉
postman	邮差
shirr	橡皮线
speciously	像是真实地
screwy	疯疯癫癫的
preludial	序幕
roadmap	路标
scottishry	苏格兰人品质
eunuchoid	似阉人的
happenstantial	偶然
coessential	同素
primidone	普里米酮
scrollwork	蔓叶花样
malformed	畸形
publican	收税员
soap	肥皂
topology	拓扑
insentient	无知觉
samely	单调
easygoing	悠闲的
uncultured	无教养的
boff	博取笑声的台词
banishment	驱逐
grate	炉
fjeld	冰蚀高原
pale	使失色
uhf	超高频
nonsuch	无与伦比的事物
slate	石片
reembroider	加绣
declarer	申报者
skiagram	=sciagram
laborious	勤劳的
febrifuge	退热药
throng	群集
hyperpituitarism	垂体机能亢进
baroness	女性男爵
variomatic	皮带驱动自动传递
hex	施魔法于
adjectivally	形容词般
sodomist	鸡奸者
placed	放置
omsk	鄂木斯克
physiological	生理学上
possessory	所有者
dressily	衣着讲究的
desaturate	使不饱和
unclos	on
snide	不诚实的
iso	International
carking	恼人的
unprejudiced	没有成见的
overseer	工头
tif	Image
wassermann	=Wassermann
epileptoid	类癫状的
qwerty	与英文打字机键盘一样的
portmote	自治市法院
sadomasochism	被虐待性变态
crystalline	水晶
fully	完全
unshapely	不匀称的
culturist	养殖者
enamel	珐琅
swiss	瑞士人的
dialogically	对话
eunomianism	极端阿里乌主义(公元4
faery	仙境
unreasoningly	无理智
polymely	多肢畸形
nephridial	肾的
other	不同
prolapsus	下垂
sunder	切开
realizable	可实现的
pronunciation	发音
knap	小山的山顶
fearful	可怕
hogwash	猪食
rivalrousness	敌对性
bully	威吓
magnific	崇高
backpat	赞许表示
resolutive	使分解
fine	精巧
dateless	无期限
woodenheaded	愚蠢
nasofrontal	鼻额的
superacid	酸性过多的
scute	盾板
crystallogeny	晶体发生学
makable	可建造
contract	合同
overdone	overdo的过去分词
plunder	战利品
gemutlich	和善
buffo	演滑稽角色的男低音歌手
dissect	把……切成碎片
subsidiary	辅助的
frostline	冻深线
satire	讽刺文学
ranging	距离修正
infinitely	无穷
decency	庄重
mastitis	乳房炎
peck	扔石头
expressionless	无表情的
ferroalloy	铁合金
tough	坚强
expansion	辽阔
unchangeable	不能改变的
pool	合伙经营
klieg	light
wtc	美国世界贸易中心
somatological	人体学
palpable	可触知的
crystal	结晶状
heitiki	绿玉人像颈饰
chance	可能性
moderato	中板地
alleyway	小巷
enroll	登记
truckway	运货汽车道
assheaded	笨蛋的
acrobatics	杂技
impervious	不会受到损伤的
irreproachable	不可非难
embryotrophic	胚胎营养素的
streamlined	最新型的
earnest	重要
sciolto	断音地
tinker	笨拙的修补
asteroidean	海盘车类动物
contrecoup	对侧伤
distensile	会扩张
chewy	耐嚼
ochreous	赭色的
gelatiniferous	产树胶的
rheumy	潮湿
genista	金雀花
wield	挥
sinistral	左首的
furunculoid	像疔疮
inerrant	确实的
immobilise	使固定
pacificator	平定者
embodier	具体表现者
choke	阻塞
raving	胡言乱语
ralline	似秧鸡的
stormbound	因暴风雨而被困的
comtian	实证论的
lace	鞋带
greedily	贪食
hairstreak	翅上有细纹的蝶
legatary	遗产
prospect	景色
physiographical	文学
distinguished	著名的
rediscovery	重新发现
housebroken	管教好的
cyclone	飓风
disgruntle	使不高兴
separative	分离性
endearing	引起爱情
overhear	偷听
plank	政纲条款
douai	Bible
rontgen	X光的
grudge	不给予
trichroism	三色现象
constellate	遍布闪耀
uninterrupted	未受干扰
tolerance	宽容
fly	飞行
grieve	忧伤
ytterbous	镱的
quintefoil	五叶形的装饰
unconditional	无限制的
chasseur	追击兵
allochthonous	属曾被地壳动力搬移
formic	蚁酸的
sticky	粘性的
inactivity	静止
easternmost	极东
roadability	车辆行驶安定性能
circumlittoral	沿海的
leucoderma	白斑病
pigeonhearted	胆小的
epimerase	差向酶
inexorable	无情的
builder	增洁剂
gesticulatory	做着手势
inflexible	顽固的
hypnology	催眠学
isochroous	各部分同色的
bacchic	醉的
gayly	华美
trimethylamine	三甲胺
lustreless	无光泽的
turntail	胆小鬼
uninvoked	未被恳求
tufty	多穗的
unwrung	不被扭曲
dreamy	多梦
mitigative	平静
musaceous	香蕉科的
workgroup	工作组
intacta	保持童贞
reinstitution	再设立
survey	测量
fluorography	荧光照相术
aureate	金色
footlights	脚灯
underwritten	underwrite的过去分词
hump	驼背
cartoon	卡通片
unbefitting	不相宜的
panglossian	认为一切都趋于至善
bobsleigh	长橇
umbilicate	脐状
lesgirls	女子们
proficient	精通
tame	驯养
elide	省略
miniscule	草写小字
medieval	老式
unicef	Children''sEmergency
acetobacter	醋菌属
gammon	胡说八道!
irradiative	有启发作用
repeal	放弃
crambo	对韵游戏
vaporizer	喷雾器
phonic	声学
oftimes	=often
jeepers	天呀
batty	蝙蝠的
enumerate	列举
dac	Douglas
ilo	国际劳工组织
plump	丰满的
noisily	吵闹
reedy	芦苇丛生
assuming	不逊的
severally	各自
francophobe	反法国的
necromania	=necrophilia
engobe	釉底料
dismiss	解职
remittal	减轻
tetraploid	四倍体
trusteeship	托管人职责
goddam	诅咒的
dolly	捣碎
collagenous	成胶
unmercenary	非雇佣
cognac	白兰地酒的一种
apperception	领悟
valued	贵重
veracious	诚实的
garnet	深红色
tasty	好吃
rigorism	严格
spindling	细长的
lockable	可锁定的
impercipience	无知觉
tooling	加工
fruitage	果实
ribbed	有肋骨
atlanticist	大西洋主义者
some	相当
ruly	有条不紊的
past	晚于
wilding	野生苹果
alignment	队列
dominancy	统治
bouffe	滑稽的
industrialize	使工业化
readapt	重新适应
quaquversal	向四方倾斜
scalding	滚烫的
geostationary	与地球的相对位置不变的
divinatory	占卦
areological	火星科学研究的
allude	影射
helminthoid	蠕虫状的
scalenus	斜角肌
tergiant	显示出背部的
mortal	极端的
dishtowel	擦碟干布
odour	臭味
checked	格子花纹
slack	静止
hardy	难的
illiberalism	反自由主义
glycine	氨基乙酸
feculence	变浊
uncommunicative	沉默寡言
mullah	毛拉
fruit	水果
righty	用右手
amort	意志消沉
whitebait	银鱼
antiblack	反黑人
udf	Disc
mackinawite	马基诺矿
sonsy	开朗的
ligeance	封
regulate	管制
mite	微小的东西
distant	冷漠的
calculate	认为
unconstrained	不做作
humorless	缺乏幽默感
indefeasible	不能废弃
counterfort	山嘴
stolid	神经麻木的
auriferous	产金
skip	急速改变
caip	Cable
cellularity	多孔性
contemptibly	下贱地
doorstep	入门之阶
bora	吹袭亚德里亚海沿岸的季节性东北冷风
trichrome	三色
endometrium	子宫内膜
toggery	服装店
iricism	=Irishism
pigmentary	颜料
cowardly	胆怯地
nonlicet	非法
conformable	适合的
stolid	不易激动
mistakable	易弄错的
mariticide	杀夫
neurohormonal	神经激素的
couchy	茅草的
woodsy	树林中
stanhope	单人乘座轻马车的一种
sunburst	从云隙射下的阳光
ravined	布满沟壑的
foresaid	前述的
ascap	Society
twentieth	第二十的
incessant	不停
dampness	潮湿
ilmenite	钛铁矿
haut	上流社会的
banjax	打
chagul	羊皮做的水壶
reinforce	加固
physical	物质的
sbirro	警察
adhesive	胶粘
blaspheme	辱骂
forever	常常
factotum	打杂的人
subcelestial	尘世
fiefdom	封地
hatefully	憎恨
pyrocatechol	邻苯二酚
extraatmospheric	大气层外的
notification	通知
clindamycin	氯洁霉素
seeder	播种机
deemphasize	不再给予强调
attica	阿提卡
anapestic	抑抑扬格的
satellization	附庸国化
sole	基础
widf	International
epidermal	外皮的
cash	现金
camberwell	坎伯威尔
formular	公式
shelly	壳
waterlogged	浸满水的
thowless	无生气的
gatetender	看管铁路平交道栅栏的人
synodal	宗教会议
pasteurellosis	出血性败血病
whitleyism	惠特利主义
rollaway	滚移
bunglesome	笨拙的
pentagonese	军界行话
warehouseman	仓库管理人
cockiness	骄傲自大
homefelt	痛切感到
pricket	二岁的雄鹿
bps	每秒位数。
untamed	未驯服
planetesimal	星子假说
aacs	and
cpa	Canadian
hypaesthesia	感觉迟钝
antiperspirant	止汗药
unanimous	意见一致
jurisdiction	权限
distributive	分配
incompatible	性质相反
discommodity	不便
hearty	衷心的
ministry	部门
gath	=gat
permissibly	到许可
early	早熟的
rheologic	流变学的
loiteringly	吊儿郎当地
fungistatic	抑制真菌
vinosity	酒质
fettle	整顿
unsearched	没有寻找过的
woundy	极大的
moll	妓女
semiotic	记号语言的
stoep	屋前游廊
prepsychotic	精神病前
cowling	飞机引擎罩
pardi	无疑
birdwoman	女飞行家
yomp	艰苦跋涉于
interspatial	层际空间
seminude	半裸
reverberation	反射物
glulam	胶合层木
nonperson	微不足道的人
ternate	三个一套的
brucine	番木鳖碱
gigue	吉格舞
flush	使脸红
contingency	可能发生的附带事件
devotion	投入
privy	有利害关系的人
excerption	选录
hearty	亲切
myrialitre	万升
delusive	令人错解的
diabetes	糖尿病
warp	变的反常
hieron	圣地
inosculate	融合
by	由
midgarth	尘世
wnp	Nationalist
ciliate	纤毛虫
imploring	恳求
plumose	有羽毛
liabilities	负债
aerobatics	特技飞行
rooftree	栋梁
enrolment	入学
segregationist	隔离主义者
proctitis	直肠炎
poor	可怜的
sporicide	杀孢子剂
stinking	烂醉
perambulatory	巡行的
quizzical	嘲弄的
hyperuricaemia	高尿酸血
unequable	无规律
transactor	处理者
loophole	望孔
affright	恐怖
hood	给……加罩
rejoneador	马背斗牛士
aborigines	土著
legit	合法
lunate	半月形
unstuck	松开
tease	嘲弄
infertile	不毛的
forward	前进
reflectible	能反射
secateur	修枝
kartell	企业联合
hieroglyphic	象形文字
assamese	阿萨姆人
odditional	加添
bladdernose	冠海豹
jewelly	光彩夺目
smother	窒息
brahman	印度产的牛
bachelorship	独身
ruching	褶饰
negligible	不予重视
xerantic	除湿
trail	追踪
exhaust	用不完
finality	最后的事物
unbelieving	不相信的
editorial	社论的
tetartohedral	具有四分之一结晶体对称面的
infatuatedly	着迷地
burger	各种夹饼
coarctate	身体包在干壳中的
hydrocyclone	水力旋流器
uruguayan	乌拉圭
printer	印刷工
knobstick	瘤头棍棒
innumeracy	无数学和自然科学知识
monstrous	恐怖的
secretory	分泌的
alleyway	窄街
usb	Universal
autograft	自体移植物
bakelite	酚醛塑料
samekh	希伯来语的第十五个字母
cylindromatous	圆柱瘤
vstol	垂直短距起落
pinpoint	精确
harshness	刺耳
solutizer	助溶剂
sponsor	主办人
anticonvulsant	抗惊厥的
pratie	土豆
dastardly	卑鄙
testily	暴躁
verification	诉状结尾的举证声明
nones	3、5、7、11月之第7日或他月之第5日之祈祷
doven	=daven
customshouse	=customhouse
neovascularization	新血管形成
rescript	抄件
hierogram	圣符
semisocialist	半社会主义者
ames	艾姆斯氏试验
alien	相异的
unbalance	使能避免的
significs	符号学
housecoat	家常服
hyetograph	雨量图
duvetine	混纺毛织品的一种
austronesian	语族
persuasion	说服力
motorial	运动
dubious	不确定的
cannibalize	拆用配件
ornl	Ridge
bryant	布赖恩特
brandied	加白兰地酒来调味
alehouse	出售麦酒的酒店
ransom	敲诈
courteously	亲切地
tipple	烈酒
transgression	违反
space	余
print	印刷物
shoreward	面向岸的
unsound	不稳固的
sup	一口
scumble	将色彩变淡
framer	创作者
bedraggled	荒废
dotal	嫁妆
anthrop	人类学
interzonal	地带间的
substruction	地下建筑
spelk	木片
initial	初始
swingometer	选票指示器
longhead	头颅长的人
engrain	染成木纹色
passimeter	绕杆
electrolysis	电解
quaveringly	震动
cramp	难解的
ndea	Education
transposal	易位
annaba	安纳巴
baltic	波罗的语
masonwork	石工
antiphrasis	反用法
surgical	手术上
attractively	迷人
underplay	不充分的表演
asininity	愚钝
cavetto	凹弧饰
polt	图谋
animated	活泼的
nix	拒绝
rabelaisian	粗俗幽默
demonstrationist	参加示威者
unmeaningful	不重要
busily	忙碌
cement	巩固
export	输出
officialis	首席法官
hesitant	犹豫的
dilettante	业余艺术爱好者
hydrodynamics	水动力学
praties	洋山芋
heads	正面朝上
alu	Unit
units	单位
fluid	不固定
abac	算图
unreconstructed	脑筋转不过来的
incorporeal	灵魂
failing	失败
subdural	硬膜下的
alumina	氧化铝
cryptical	含义模糊的
reapparel	再穿衣
whimling	懦弱的人
hyp	使忧郁
silverpoint	银尖笔画法
borescope	管道镜
broadcast	播送
positivism	实证论
homopterous	同翅类
sweeping	广泛的
inarticulately	口齿不清地
cheralite	磷钙钍矿
mamillated	有乳头状突出物
ungainly	不雅
phanerogamous	开花
telnet	远程登录
martlet	圣马丁鸟
treadwheel	令人厌倦的工作
hexapartite	分六部分的
depressible	可抑压的
adrenocorticotro	促肾上腺9kR:tIkEJ`trCfInkR:tIkEJ`trCpIk/9kR:
sioux	苏语
metaphyte	多细胞植物
modeless	非模态
bombycid	蛾的一种
domain	领地
leaden	铅制
pat	人为
arithmetical	算术
metallotherapy	金属疗法
strongyloidiasis	类圆线虫病
notional	实义的
shaef	Allied
finale	结局
whetter	增强物
prosaically	平凡地
fibrosis	纤维症
beseech	哀求
unmeaning	呆板的
mariolatrous	崇拜圣母马利亚
sugarbush	糖枫丛林
carrucate	=carucate
mlw	平均低水位
tragical	悲剧性的
lockable	可封闭的
acquired	后天通过自己的努力得到
abuzz	嗡嗡的
rejuvenate	复原
singular	持异议
breezy	通风好的
triable	可判定
flocculent	羊毛状
chancriform	下疳似的
swaybacked	背凹了的
unremitted	未赦免
doltish	愚蠢的
illustrational	举例说明
nonpositive	非正的
reflectible	能反照的
photoautotroph	生物
horrific	可怕
uncdf	Nations
chub	白鲑
septangular	七角的
lightless	暗的
admire	羡慕
tintinnabulary	丁当响的
enthronement	即位
dissipated	闲游浪荡
inescapable	逃不掉的
rentable	可出租的
polonaise	波洛涅兹舞
forwarder	代运人
catarrh	卡他
cernet	Education
pension	退休金
sellout	出卖
unpretending	不骄傲
inrush	涌入
resuscitable	能恢复的
povera	概念派
drupe	核果
herbary	菜园
lamish	有点跛的
parch	烤干
ring	环状
shirtdress	衬衣式连衣裙
diaeresis	分音符号
doorward	向着房门
metrological	度量衡学
sextus	第六个的
dubitatively	怀疑
afflicting	痛苦
furmety	牛奶麦粥
epiphytotic	植物流行病
navigate	航海
noontime	中午的
inhospitality	冷漠
qualify	限定
tottery	摇摇欲倒
impish	似顽童的
recognition	公认
decussate	交叉着
linseed	亚麻子
thinnish	较细
pmla	of
undercapitalize	投资不足
hdl	density
sanitarily	在卫生方面
pathfinder	开创者
hyperpituitary	垂体机能亢进
stealing	偷窃
loot	劫掠
jarring	不和谐的
honcho	老板
heresimach	与异教
arthrotropic	向关节的
watering	洒水
whydah	寡妇鸟
total	总数达
brix	白利糖度的
lothsome	=loathsome
aiche	Chemical
revolvably	能被旋转
antiphony	唱和
surveillant	监督者
striped	有斑纹
sick	使狗去咬
finish	停止
impeachable	可控告的
meeken	变温顺
antimonic	锑
philhellenism	亲希腊
prefigurative	预示的
culpably	可恶
vocative	呼唤
seclusive	喜隐居
dene	沙地
plateresque	带复杂花叶形装饰
archer	射手
fallen	伐倒的
nonfinite	非限定
tea	茶叶
righty	右派
lucubrate	深入研究
benedictive	赐福
whet	磨
crannied	裂缝多的
cleat	夹板
featureless	无特色的
ctenophora	栉水母类
semibarbarian	半野蛮
choosey	好挑剔的
anthropomorphosis	Es/
usurious	高利贷
raddle	红赭石
sound	可靠
chromophoric	发色团
friar	行乞修道士
undercut	从下边削球
dilettantism	业余的艺术爱好
escarpment	悬崖
disadvantaged	处于不利地位
rewinder	复绕机
chopsocky	功夫片
disculpation	开脱……的罪责
standing	常设
kigali	基加利
wand	杖
entrench	以壕沟防护
reductor	减速器
freely	自由地
curtana	无尖刀
remedial	治疗的
barbola	剪贴画
homing	自导引的
autolithograph	用直接平版印私版印刷法的
damnable	可诅咒的
bobtail	截短的尾巴
roper	制绳者
yucatec	尤卡坦语
eschew	远避
overshade	=overshadow
bromoform	溴仿
matchbyte	匹配字节数
dirtily	下贱
blissful	有福
scenical	景色
consummate	完美
extern	外的
rumply	压绉的
theophobia	对上帝的恐惧
soundex	探测法
glossarial	词汇
kruller	油煎饼的一种
seity	个性
malarious	瘴气
pharmaceutics	配药学
likely	合适
troubadour	行吟诗人
unordinary	特别的
quakeress	贵格会教派女信徒
filigreed	饰有金银丝细工的
furthermost	最远
goober	花生
alimony	赡养费
choriamb	扬抑抑扬格
opalesce	发出乳白色光
angulation	使成角
arrenotokous	雄性生殖的
tacitus	塔西佗
syllepsis	兼用法
florid	炫耀的
oodbs	面向对象数据库系统
contralto	n女低音
obverse	正面
mitral	礼冠
eugenic	优生
transalpine	山北居民
gigaton	十亿吨
watchtower	了望塔
economic	经济学的
karaganda	卡拉干达
woodhouse	柴棚
niff	有恶臭
androphagous	吃人的
cancellation	取消
edd	Dialect
succose	多液的
sneesh	鼻烟
downtrodden	被蹂躏
memorization	记住
botchy	难看
triclinic	三斜晶系
best	最好的东西
engrain	根深蒂固的
redefect	再度背叛
textual	本文
duplicate	两重
snakeless	无蛇的
disharmony	不调和
comp	比较两个或多个文件
pliably	圆滑地
gnosis	灵知
nottinghamshire	诺丁汉郡
official	公务
transfect	使感染病毒核酸
isoantibody	同种抗体
honies	honey的复数
walty	易横倾的
precalculus	学习微积分前必修的
deuteranopic	绿色盲
swathe	绑
isosmotic	等渗压的
sponge	诈取某人钱财
hemiglobin	高铁血红蛋白
shiftless	想不出办法
secessionism	脱离论
toxoid	类毒素
rasp	擦菜板
anodic	阳极
heterotaxis	地层变位
dipsas	致渴蛇
cymoscope	检波器
bacchic	狂欢狂饮的
alsoran	落选的马
folklore	民间传说
cnaa	Academic
samos	萨摩斯岛
expensively	高价地
guts	贪婪地吃
transmutable	可变形的
prosocial	亲社会的
chaperone	女伴
fantastically	捕风捉影
aseasonal	无季节性
funereal	悲哀
godlet	=godling
hominine	人亚科
antibusing	反对用校车接送跨区学童
soupfin	=soupfin
ballerine	芭蕾舞女
lensed	有透镜
breastwork	赶工做成的防壁
heeled	有后跟
haemic	血的
tutelary	守护圣徒
sotted	醉得稀里胡涂的
vicissitude	变迁兴衰
undismayed	不泄气
slovenry	马虎
sbc	Micyoco
hypocotyl	胚轴
nettlegrasper	迎着艰险上的人
ferocious	残忍
nannyish	过分拘谨
cgh	Good
moneybag	钱袋
poleax	战斧
triceratops	三角恐龙
devoted	投入的
plantation	耕地
hydroxid	氢氧化物
pyrogenation	热解
fame	使闻名
remorselessly	无悔意地
doomsten	凶事预告者
atrociously	残酷
illiquid	非现金
trijugate	具三对小叶的
collagen	胶原质
photopigment	光色素
bontbok	南非白纹大羚羊
nodus	节
dissectional	仔细分析的
ordinal	顺序的
fast	快速
isoseismal	等震线
ascolichen	子囊衣
unbrotherly	不友爱
aau	业余体育联合会
underpitch	vault
guanase	鸟嘌呤酶
camp	阵营
rvsvp	p
fslic	and
reread	再读
acting	代理
petite	小的
datamation	资料处理设备产销公司
skillfully	巧妙
pernoctate	守夜
micrometer	测微计
failure	失败
coronetted	贵族
purgatorial	涤罪
heterogametic	异形配子的
unclouded	晴朗的
foregone	先前
cognise	=cognize
uh	upper
unlucky	不幸的；不吉的
seventeeth	第十七
mercuric	含水银
spaggers	意大利式细面条
scalar	标量
leeway	风压角
acoustical	声学
continual	频繁
canalicular	微管
tinhorn	华而不实的
pearlescent	光芒四射
nanoid	矮小的
simpleminded	头脑简单的
perlustrate	彻底检查
lamentableners	可怜
tsunami	海啸
nummulated	钱串状的
adi	daily
delinquent	违法的
answer	反响
indemnification	保护
jib	起重机的臂
unbrotherly	不亲切
hyperextension	过伸
violaceous	紫罗兰色的
peewit	田凫
parallelism	类似
failingly	似将消失
stearin	硬脂
beatification	受福
equally	公平
dilatorily	迟缓地
sunlike	太阳似
ultraliberal	极端自由主义
klick	公里
interscholastic	校际的
parsimonious	吝啬
tuan	老爷
square	公平的
infallibly	绝对无误
circuit	周游
gorge	峡谷
chloromycetin	氯霉素
sufferable	可容忍的
fecundity	结实性
murmur	发怨言
stouthearted	大胆的
anoscope	肛镜
indigoid	靛蓝类的
airdrome	飞机场
bloodily	残忍地
cleavage	分裂
antidraft	反征兵
kickup	吵闹
telephone	电话机
bolt	囫囵吞下
human	有同情心的
hairologist	头发保养专家
unpunished	未受惩罚
arrant	极恶的
pivot	重点
mirthquake	令人捧腹大笑的表演
uncalculated	未经事先考虑的
chengtu	成都
phanariot	法纳尔人
atman	灵魂
acerbic	尖刻的
zoologize	对某一动物作动物学上的研究
trilobate	具三裂片的
undistinguished	普通的
ratiocination	推理
clou	最引人处
guestchamber	来宾室
ample	充足
bulkiness	庞大
indigen	当地的动物或植物
protect	保护/解除
halm	茎
columbine	鸽似
homogenization	同质化
milord	英国绅士
wash	洗涤剂
antielectron	正电子
wwf	Wildlife
enepidermic	对皮肤用药的
molluskan	=molluscan
intacta	未经触动的
columbian	美国
grace	优雅
bovine	迟钝
stall	出售摊
ensue	追求
orthodox	传统
emarcid	枯萎
paynim	非基督徒
quirky	离奇
tripartite	分成三部分
slimsy	不结实
countrywoman	农妇
altometer	高度测量器
expedition	迅速
erumpent	裂出的
psi	字
mollescent	变软
enlighten	启蒙
reassert	再断言
annexation	合并
calx	生石灰
aggregately	合计
life	传记
bedpan	便盆
distraction	分心
middleweight	平均体重
indeterminable	不能决定的
hypoglycemic	低血糖症的
advertence	注意
redeye	铜头蛇
undisguised	公开
hemingwayesque	海明威作品特色
jurimetrician	法律统计学家
harsh	刺耳的
brachypterous	短翅的
gentlest	温和的
reuptake	再吸收
luik	=Liege
unphilosophical	缺乏哲理
adumbrate	画轮廓
treasonable	叛国的
fuddle	使烂醉
rear	后面的
cadenza	装饰乐段
smuttiness	猥亵
puntil	顶底杆
hackmanite	紫方钠石
xenoantibody	异种抗体
inundate	淹没
hidrosis	出汗过多
significant	重要
triclinic	三斜的
brawling	喧嚷
overgorge	吃得过多
kofu	甲府
cytolysin	溶细胞素
fewtrils	琐碎东西
unpruned	未修剪的
tvp	vegetable
isolato	被遗弃者
capriciously	善变
gassing	毒气攻击
primely	极好
supernal	高
gaskin	后小腿
thermomechanical	热机的
audio	声频
shag	使蓬松
slavic	斯拉夫人的
balsamic	香膏质
neostigmine	新斯的明
orchestration	管弦乐编曲
villainous	恶毒
ampliative	扩展
maternalize	使成为母亲
nocuous	有害
unbury	从坟墓中挖出
porbeagle	鼠鲨
wattless	无功
interlinear	隔一行书写原文和译文的
lyrical	热情
sourly	酸酸地
finfooted	蹼足
toadstool	毒菌
gabbroid	似辉长岩
dnepropetrovsk	第聂伯罗彼得罗夫斯克
campaign	活动
antiperiodic	抗周期性病
odt	Office
kneecapping	用枪击穿膝盖骨
ted	翻晒
clownish	滑稽
operational	操作
he	男
interpolator	撺改者
lex	罗马私法
tungstite	钨华
tripey	无价值
embarrassingly	使人为难地
saxicolous	岩栖的
ecclesia	教会
fantasise	=fantasize
time	记时
galoisian	伽罗瓦的
neurospora	脉孢菌
reginal	女王
crawl	缓慢的行进
portulan	chart航海指南
inflator	打气筒
mopoke	笨人
prolate	扁长的
succose	多液
tussal	咳嗽表现
washland	泛滥地
skiamachy	=sciamachy
censoriously	吹求疵地
fair	公平地
inkwriter	印字机
marketable	适于销售的
stagecraft	上演术
matronage	主妇们
sorehead	发怒的人
kitling	如小猫
violet	维奥莱特
hypnotically	催眠地
marathonian	马拉松平原
gingerly	极为小心地
promiscuously	杂乱地
technically	工艺上
persiennes	百叶窗
superradiant	超发光
nisi	非最后
jet	黑玉色
radialized	辐射状
endomysium	肌内膜
ligeance	封地
rigmarole	胡言乱语
biedermeier	保守的
indigestibility	难理解
vbscript	描述语言
diligently	坚持不懈
tough	艰苦
choker	使人窒息之物
infuriation	激怒
colourplate	套色彩印图片
lithographic	平版印刷
sullen	沉沉不乐的
merohedral	缺面的
faulted	有缺点的
thwack	拍地一声打
tuum	你
uneventful	无重大事件
devolution	委付
theca	囊
iconological	肖像学
nitty	愚蠢的
collogue	畅谈
postmortem	尸体检查
muff	保温的
khansamah	男管家
livery	制服
quota	限额
hominine	有人类特征的
aujus	带原汁的
skywards	向天空
expo	博览会
seaside	海边
willing	心甘情愿
confusion	混淆
petala	的复数
czechish	捷克斯拉夫
ultrarapid	超速
tony	高贵的
inappositely	不贴切
dragonish	凶暴
liberative	同意释放的
perceptual	有知觉
barite	重晶石
unequivocable	明确
irretraceable	不能再找到的
busheler	修补衣服的人
dcm	Conduct
ferdelance	一种大毒蛇
nondisorimination	不歧视
monopolylogue	单人多角戏
usom	United
basined	为盆地所围绕的
aldol	丁间醇醛
footling	无价值
rac	英国皇家飞行俱乐部
townish	城镇特有
claxon	=klaxon
hysterectomize	切除子宫
squalor	肮脏
gular	外咽的
galenic	古希腊名医伽林
exorbitant	过度的
alba	Alva的称号
unshrinking	不收缩
reparative	弥补的
uncreate	使不存在
ungainly	难看的
pupal	蛹
respirate	对……进行人工呼吸
endocytic	内吞作用的
cerebric	脑的
ruling	流行
adjudicator	裁定者
w	三柱门
blindfold	将……眼睛蒙起来
sweeping	规模大的
impregnant	浸渍剂
bridle	马勒
sociocentrism	群体中心论
coordinator	同等的人或物
joltheaded	笨头的
gooseberry	醋栗树
subsection	分段
preference	偏爱
buckshee	免费
sizable	相当大
sandbar	沙洲
wrongfully	不妥
design	图案
libyan	利比亚的
europocentric	欧洲中心论的
rarer	更稀罕
acarpelous	无心皮的
deliberation	熟思
xanthippe	泼妇
complacent	自满
kidlet	小山羊
barnstormer	乡区演说家
paramo	高山稀疏草
howbeit	仍然
rattlebladder	嘎嘎泡泡
gardenly	如花园的
nascar	National
distolingual	远中舌的
unpublicized	未经宣传
atomicity	原子数
donnybrook	大混战
hunt	打猎
abluent	洗洁剂
polyhedra	polyhedron
pessimal	最差的
gpm	加仑
somersetshire	萨默塞特郡
filamentous	如丝
unroost	把……从栖息处赶出
unscientific	无科学知识的
do	多米尼加共和国
mouthy	说大话的
slovenry	懒散
wash	虚假
weltpolitik	国际政治
wesleyanism	卫斯理宗教义
rhizopodan	似根足虫纲动物的
elimination	消除
torsional	扭转
neotene	幼态持续品种
cratered	多坑
equanimously	镇定
upbear	托起
shlump	=schlump
circlewise	环形
emotionless	没有情感的
homodont	同型齿
hade	断层倾角
rasped	易怒
truelove	纯爱
daybill	戏剧或其他娱乐节目之海报
colourable	可着色
attribute	加于
cresylic	甲酚
rondoletto	=rondino
unprimitive	发达
ocherous	赭石
quarter	地区
lucidly	透明地
pressingly	强求
albino	白化变种
start	起程
sorority	妇女联谊会
unbaptized	未受洗礼
esb	of
delinquent	违法者
coca	古柯叶
putridness	腐化
exertion	努力
shillingsworth	1先令的价值
unpenetrable	不能穿入的
asap	As
rivel	皱纹
digenetic	世代交替的
registration	报到
laryngitis	喉炎
tailstock	尾架
bluesman	演奏
theater	戏院
elysian	幸福
assimilative	同化的
nonsuch	绝品
abound	多
methanogen	产烷生物
epiglottal	会厌的
undignified	有损尊严
perfect	全然的
counterfactual	反事实
stench	恶臭
lovesick	害相思病
entail	使蒙受
domesticate	驯养
gymnosophist	秘密信仰的信奉者
ministrant	服侍者的
dharma	达摩
osteological	骨学
remoralize	重新赋予……道德含义
and	接着又
culturist	栽培者
jo	约旦
thereof	将它
nonsuch	极品
seducible	容易受人诱惑的
knocking	卡答卡答的故障声音
deracialize	使消除种族特征
saintly	圣洁
primine	外珠被
boronia	芸香料灌木
drophead	活动头
unfathomable	难解
visive	视的
ghostliness	影子似
mouthwash	洗口药
hood	车蓬
monotonous	无变化
anteporch	外门廊
laryngismus	枯声
vehemently	激烈
recolonization	再度移民
variorum	有诸家注解
philosophise	=philosophize
suspense	悬念
czarevitch	沙皇的长子
ltjg	Grade
depart	逝世的
gastrohepatic	胃与肝脏
sloughy	泥泞
reprovingly	责难
semiautobiographical	半自传性
mestizo	混血儿
submundane	地面下的
gesture	姿态
yet	然而
spearhead	先头部队
hemeralopia	昼盲症
pronunciation	读法
bonavacantia	无人继承的动产
iodophor	碘载体
encina	橡树的一种
square	正直的
editorial	社论
idioglottic	自语症的
honeyfogle	用甜言蜜语欺骗
pseudonym	假名
slack	呆滞
newscaster	新闻广播员
tycoon	将军
spiniform	脊柱形
leafstalk	叶柄
agonizing	痛苦难忍的
affront	面对
sutural	缝合线
perishingly	讨厌地
sinuate	波状的
yow	痛苦
slopehead	东方人
mda	单色显示适配卡
dhaka	达卡
pudding	布丁
romania	罗马尼亚
doomed	命定
shaviana	有关萧伯纳的文物
pensionary	受雇佣者
ultrastructure	亚显微结构
unconcerned	无忧虑的
decasyllable	十音节
antifoulant	防污物质
uw	w
binal	两倍的
isoeugenol	异丁子香酚
phototherapy	光线疗法
rare	半熟
fount	储油器
lilied	多百合花的
telanthropus	泰尔人
intuitional	直观的
heavy	重的
wvf	World
price	标明价格
aristotelean	亚里斯多德
ocean	海洋
satinet	缎纹棉毛呢
warlock	术士
plebeianize	使平民化
extort	逼取
spiritualistic	唯心论
climax	高潮
contemplative	冥想的
atmospherical	气压
initiate	发起
noisiness	吵闹
bracer	勒紧的人
corporealize	使具有形体
checked	选中的
spy	探员
itt	and
corruptibility	腐败性
unspeakable	可怕的
halftone	半音
foremost	最先
cablet	圆周
overshoot	打过头
norwards	向北方
canephore	=canephor
belabour	就……作过分的冗长的讨论或分析等
mashhad	马什哈德(即麦什德
saugh	=sallow
kampong	部落
faddish	流行的
purlieu	范围
recollected	冷静的
maquette	初步设计的模型
beiruti	贝鲁特人
singlestick	单棒比赛
ophthalmoscopy	检眼镜检查
wingspread	翼幅
cloistral	修道院
mesial	中央的
electrocapillarity	电法毛细管现象
meadowy	牧草
haymow	干草棚
frigging	可恨
judy	朱蒂
tylopod	有胼足的
reasoned	理由充分
fubsy	肥胖
walter	沃尔特
menorrhagia	月经过多
callback	复查
leewardly	脱离航路
jarring	冲突
quadricentennial	400岁
trypanocidal	杀锥虫
christian	信基督教的
callback	回叫信号
rainless	少雨的
natter	瞎扯
turbojet	涡轮喷气飞机
tangoist	跳探戈舞者
rumply	弄绉的
preaxial	上肢内恻的
fracture	破裂
nita	尼特
meristem	分裂组织
candor	坦白
gig	旋转物
subsist	生存
coign	突出之角
heliotropic	向日性
reduced	简化的
acquirement	取
showplace	名胜
aborad	对口侧
multocular	复眼
tintinnabulary	铃声的
documentary	文献片
paragraphic	短评的
caressant	爱抚的
furioso	演奏得很有力的
scepter	节杖
seat	座位
puller	划手
slim	不足取的
emplane	使乘飞机
denominative	自名词或形容词派生出来
charming	娇媚的
jackson	杰克逊
siding	铁路的侧线
architectural	建筑学的
inversely	相反地
laboratorian	=laboratorial
oyes	听
laager	临时防御营地
videoplayer	放像机
samplesort	抽样排序
twitch	急扯
burgee	燕尾旗
toothsome	可口的
insalubrity	不健康
sternutative	催打喷嚏的
dogmatise	=dogmatize
hadst	have的第二人称单数过去式
metro	伦敦地下铁道
slickness	花言巧语的
gymnastical	=gymnastic
savagely	残酷地
cryptical	神秘的
unconscious	未发觉
calloused	变硬的
pilot	驾驶
bifilar	双线
idle	无用的
firebreak	防火道
wave	致意
gastrologist	美食家
prevaricator	说话支吾的人
philobiblic	爱书的
acerous	无角的
outpour	流出
deceased	已故
ration	配给
hma	High
servient	从属
contributing	贡献
recoronation	君
arpeggione	吉他式大提琴
statistic	统计学的
frequentative	反复动词
compulsory	被强迫
redescend	重新下降
unpregnant	不合适的
veteran	经验丰富
beneficial	受益
stud	大头钉
vopo	=Volkspolizei
biologist	生物学家
livelily	活泼
periderm	周皮
nimble	敏捷的
pent	郁积的
translatology	翻译学
motorial	运动神经的
karyotheca	核膜
exodontics	拔牙学
liveborn	活胎产的
autogenetic	无生源说
worthy	知名人士
mesenteron	中肠
rantankerous	不怀好意的
insectival	似昆虫
astrography	天文定位器
paramoecium	=paramecium
cadential	节奏
frontlessness	没有正面
charleston	查尔斯顿
narrow	精密的
god	偶像
antheral	花药
respect	敬意
fauna	动物群
tenacious	顽强
farthest	最大限度地
quatorzain	不规则十四行诗
hake	鳕鱼类
rowdydowdy	吵闹
diverse	不同的
caul	胎膜
accroach	非法占有
amphimictic	两性融合
falchion	剑
ergastic	后含
respiration	呼吸作用
noncellulosic	非纤维素
idiophone	如三角铁
arenaceous	沙质的
urban	市内的
marquee	选取框
cassock	袈裟
torc	金属项圈
aeroview	空中俯瞰图
hazardous	危险
heibei	河北
eupatrid	世袭贵族的
fusspot	老是大惊小怪的人
distance	远离
kanuri	卡努里人
pensionary	受豢养者
lavish	浪费的
frowsy	懒散
schistous	片岩状的
unaired	潮湿
officeholder	官员
acyclic	非循环的
hance	椭圆拱脚尖最短半径的弧
cyclopedist	百科全书编辑者
woolly	羊毛的
methodist	卫理公会派教徒
flow	洋溢
shippable	可运输的
impersonalism	非人格性
iad	International
semifinished	半完成的
squeal	抱怨
cannonize	使加入圣徒之列
handbound	用手装订
ganges	恒河
boatage	小船运输
consistent	一致的
pale	无力的
sphacelous	患坏疽
herbage	草的柔软部分
exacerbate	增剧
cholinomimetic	类胆碱
basipetal	由上往下的
drawnet	=dragnet
son	耶稣基督
redoubted	可怕的
ddvp	二甲基二氯乙烯基磷酸酯
denunciatory	攻击
translatable	可译
basal	基础的
limiting	限制的
ontogenetic	个体发生
saurophagous	以蜥蜴为食
shanty	棚屋
unabridged	完整的
hemiola	黑米奥拉比例
bottom	底部
bloodmobile	巡回采血车
frisian	Friland
blameful	应受责备
confirmable	可以确定
flog	迫使
anticlimactic	突减
helvetian	瑞士人的
appropriation	拨款
assibilate	使齿音化
study	学习
irish	爱尔兰人
gruesome	令人厌恶的
gantt	甘特设计
reappraise	重新评估
ritually	依据仪式上地
namechild	用某人名字命名的孩子
kindlessly	薄情地
oxalacetic	=oxaloacetic
rheumy	稀粘液
humane	仁慈的
fervently	热心地
stale	不新鲜的
relievedly	宽慰
hexachord	六度音阶
braky	多矮树林的
lithe	柔软的
airline	定期航线
interceptive	妨碍
unashamed	厚脸无耻
finalize	把最后定下来
psyche	灵魂
rushy	多灯心草的
latten	黄铜薄片
underprize	对……评价太低
disgustful	深恶痛绝的
initiate	发动
thinkpad	IBM公司生产的笔记本电脑
ascomycete	子囊菌类的草
unsugared	未加糖的
regionally	地域性的
pantomime	哑剧
ordinal	顺序
stably	有恒心地
hindoo	印度教
muff	保温
runch	=white
dolorous	忧伤
totally	完全
reversion	复原
indiscreet	不慎重
baculine	鞭刑的
neurotrophic	向神经的
confectioner	糖果制造人
physiological	生理学上的
unpersuasive	无说服力的
meatworks	肉类包装厂
pimply	有疙瘩
execution	实行
seamark	航线标志
whisht	无声的
quadrifid	分成四部份的
feed	靠……为生
spiriferous	有螺壳
thistly	象蓟
brachyuran	短尾亚目甲壳动物
communism	共产主义
bmx	motocross
rantipole	喧闹
unenvied	不受人妒忌
orthopsychiatry	矫正精神医学
unparalleled	无双的
bract	苞
henotheism	神教信奉一主神而不否认他神存在
momental	惯量
lingeringly	逗留不去地
discission	分裂术
nilpotent	幂零
discrimination	辨别
luteal	黄体的
hypoacid	酸减低
rcaf	Royal
physiographer	地文学者
nondollar	非美元地区
palkee	=palanquin
nausea	作呕
heartland	中心地带
gem	精华
mooneye	患月盲症的马眼
infrared	红外线的
acock	边翻卷地
shutter	安眠药
inky	给墨水弄污的
helicar	机汽车
gorilla	壮而残暴的男人
anguifauna	蛇区系
forwearied	极疲倦
cadence	调子
revalidation	从具法律效力
zany	丑角
receptible	能接受的
cbc	加拿大广播公司
electrodelic	灯光致幻
vainglorious	虚荣
punka	布屏风扇
fried	喝醉了的
farming	农事
way	路
gray	广告业的
docetic	幻影说信徒的
intelligentsia	知识阶层
burden	负担
sleepless	失眠的
included	包括的
dolce	柔声音栓
puseyite	的信仰者
fold	羊栏
earnest	定金
gilberta	吉尔伯塔
scarves	桌巾
spill	充满
orthohydrogen	正氢
wonder	奇妙
scoliid	土蜂科的
cockeyed	斜
sermonize	说教
hematogenous	造血的
cravenly	胆怯
thoughtfulness	思虑
isocracy	权力平等主义
cloddish	土块一样的
wader	涉禽类
anisomerous	不对称
sicklily	=sickly
bearish	如熊
comtism	孔德哲学
desolate	无人烟的
lentando	渐慢地
carbine	卡宾枪
ungraceful	没有风度
esplanade	平坦的空地
temple	寺
incongruously	不调和
slake	消除
independent	独立自主的
carburet	使与碳化合
retailing	零售业
latinic	拉丁国家的
enfold	拥抱
dementi	正式否认
shrunken	缩小
stop	堵塞
refloatation	离礁
unreckonable	不可计算的
doubtful	疑心
cosey	舒适的
nonfood	与食物无关
umber	焦茶色
strepitous	喧闹
uranide	铀
wins	Service
flyaway	翅状
hurriedly	慌忙
leggy	有优美的腿的
elector	有选举权的人
pastorally	田舍风光
nerviness	肌肉发达
antilogy	用语前后矛盾
frogling	小蛙
mixologist	酒吧调酒员
schistocyte	裂细细胞
firetrap	易失火的建筑物
siloxane	硅氧烷
molasse	摩砾层
disaffinity	不相同
dimetric	四角形的
interval	幕间休息
draggle	拖
freshman	新生
afeared	受惊
la	Lao
ramp	敲诈
virtuosi	古玩癖
cressy	长满水芹的
slip	滑动的
sequela	后遗症
quotidian	每日发作的
picked	精选
telepathist	心灵感应术专家
enchant	使迷惑
mission	代表团
ataraxy	心神安定
indigested	杂乱
dubious	可疑的
obtrude	强迫
secondhand	二手的
detergence	去垢性
dacquoise	蛋白酥皮奶油卷筒
completive	完成
vitascope	老式放映机
lancang	River
block	批
isolex	同词线
conjugated	共轭的
let	假设
interpupillary	瞳孔间的
tup	动力锤的头部
nevis	尼维斯岛
elfin	象小妖精
tress	卷发
idiodynamics	意念控制
medically	医学上
headland	畦头未耕的一条
tail	附于其后
jetted	用黑色大理石装饰
buttonhold	强留
sweetheart	爱人
hyposensitive	敏感度减弱
bodiless	无形
undependable	不可信赖
masseter	嚼肌
cop	管纱
hedonic	享乐的
rsj	Joist
priscian	普里西安
yonnie	石块
variorum	集注版
expect	想
suture	缝合用的线
livelily	生气勃勃
statoscope	微动气压仪
homolecithal	均卵黄
divider	间隔物
through	直通
gripe	控制
chimeric	荒诞不经
entire	完整的
loiteringly	吊儿郎当
cent	分
painless	不痛的
yiddish	犹太人
rehabilitative	使复原
pinafore	围裙
educatory	教育上
timocracy	荣誉政治
shading	底纹
vive	万岁
israelitic	古以色列的
coralberry	珊瑚莓
shoal	水浅
sullen	阴沉
yamma	亚美利加驼
laryngotracheal	喉气管
sportful	娱乐的
mend	好转
mithridatize	在……之中产生毒物而免疫
vesuvian	耐风火柴
throttle	扼杀
ficelle	淡灰褐色
spark	使有朝气
cetacean	鲸类
bismuthal	铋
intuitive	直觉的
decently	高雅
negritude	黑人文化传统的认同
rp	Philippines
lupulin	啤酒花苦味素
cutaneous	皮肤的
unbitter	非恶意的
cacotrophia	营养不良
visuosensory	视觉
share	参与
gassing	气体处理
eloise	埃勒维兹
prelatical	教长政治的
outgo	走得比……远或快
stook	稻堆
petty	卑鄙的
ordinary	平凡的
scurry	急转
intractability	难驾驭
melange	大杂烩
weatherproof	抗风化的
lunatic	疯狂的
sung	sing的过去分词
cabana	有凉台的屋子
sinful	罪孽深重的
season	季节
antiarrhythmic	抗心律失常的
nu	希腊字母第13
joyously	快乐
he	pro
lampbrush	刷形染色体
distinguished	卓著的
subdiscipline	分支
audacious	大胆
unconsummated	未完成的
enervated	衰弱
emphasize	强调
synonymy	同义字研究
lark	嬉戏
poultice	膏状药
childish	孩子气的
philhellenism	希腊独立主义
fibrogenesis	纤维发生
daylong	整天
isdn	Network
staff	供给人员
hymenopteran	膜翅目
confiscable	可没收的
tendency	趋向
discutient	消肿的
mobdom	黑社会
apathetically	无动于衷地
analogically	相似地
impayable	无法清偿的
gayer	快乐
unpresented	未提出
overknee	过膝
respectively	各个地
habited	穿着法衣
auditorial	审计员
delegable	可委托的
conjecturable	可猜想的
representable	可被代表的
impurity	不洁
intravital	活体的
edging	边饰
deratize	消灭老鼠
exclamatory	感叹的
bhut	妖怪
seignorage	=seigniorage
comfort	舒适
inexplainably	难解说地
finish	磨光
damascene	大马士革
blastomycosis	芽生菌病
lumpenproletarian	流氓无产阶级
circumambiency	周围
mutarotation	变旋
flexional	可弯曲
smogbound	烟雾笼罩的
spoken	speak的过去分词
interception	中途夺取
maoist	毛主义的
sanctum	圣
agrostologist	禾本植物学家
uncharitable	不宽恕的
green	未成熟的
nuke	核潜艇
unintelligible	无法了解
acidulous	多少带酸味
outspread	扩张的
flickering	闪烁的
disapprobation	不赞成
counterpole	正相反之事物
cordial	诚恳的
figmentary	虚构的
disrespectful	无礼
devil	魔鬼
intoxicated	极其兴奋的
oa	Analysis
hunkers	腿臀部
nonaddicting	不致瘾
bedquilt	棉被
pe	产品工程
axman	樵夫
preclear	事先批准
dimorphic	二态的
element	元素
c	转交……
grizzle	灰发
unweakened	未减弱
neuter	中性
stairhead	楼梯顶
foundation	基金会
ineluctable	不可避免
downbent	向下弯曲
kyle	狭海峡
electrophysiological	电生理学的电生理学
belemnite	乌贼的化石
gymnocarpous	裸果的
allophonic	音位变体
universal	宇宙
ding	鸣
embedding	埋入
sententious	简洁的
elicitation	引出
machism	马赫主义
crawl	爬行
factionalize	使分成宗派
uninquiring	不打听
tasse	腿罩
theomorphic	神形的
quarenden	红苹果
residency	住院医生的职位
designatum	所指
clothes	家丑
bigeneric	属间杂交
qcb	Queue
festivity	欢庆
polytechnic	工艺
calligraphic	书法
ichthyolite	鱼化石
enneahedral	九角的
nephrocardiac	肾脏和心脏
hyacinthus	雅辛托斯
eventful	充满大事
tremissis	拜占庭帝国金币
manganate	锰酸盐
countable	可数的东西
israeli	以色列共和国
interproximal	邻接近端间
musculoskeletal	肌骨骼的
aquarius	宝瓶宫
fruit	结果实
basidium	芽孢台
sketch	草图
piliform	毛样的
base	基
roofless	无家可归的
needlewoman	缝纫女工
innocent	天真
generation	一代
loose	放纵
sonofabitch	bitch
sinnet	=sennit
aram	of
unearned	不相称的
rhythmizable	予以节奏的
gunpowder	黑色火药
enscroll	记在卷轴中
cragsman	善于攀登危岩和峭壁者
toxaphene	八氯莰烯
studious	认真
abacus	算盘
grum	闷闷不乐的
ashine	发亮
beetling	悬垂的
lack	缺乏
photonuclear	光致核反应
cobbler	皮匠
doormat	擦鞋垫
pterin	蝶呤
upper	上部
dogcatcher	捕狗人
esb	brain
programming	设计
reversion	归还
eagle	鹰
hiaa	of
procrastinate	耽搁
exponential	演奏者
psychophysiology	心理生理学
smell	气味
sterile	消过毒
septette	七重奏
overprice	索价过高
pious	尽责的
moxie	精力
miscarriage	流产
diapedesis	血球渗出
sob	呜咽
tiddled	微醉
comedown	丧失
surrealistically	超现实主义
yachtsman	游艇驾驶者
auxiliary	补助
icu	care
valueless	不足道
bemuddle	使迷惑
cachaca	巴西朗姆酒
aristocratism	贵族
spirituel	活泼
defective	有缺陷的人
twig	末梢
sniff	嗤之以鼻
vinton	文顿
wickmanite	羟锡锰石
semiofficially	半官方
albuminose	含白朊的
fugue	朦胧状态
joltheaded	笨人
underhand	秘密的
tourism	游览
bay	吠
chlamydate	有外壳的
entertainment	款待
sulfite	亚硫酸盐
scantily	缺乏
sheld	duck=shelduck
uddi	通用描述、发现和集成服务
haemolysis	血球溶解
lustful	淫荡的
legionary	很多的
squirish	适合乡绅身份
wulfenite	钼铅矿
puffy	一阵阵吹
bosun	水手长
labialise	=labialize
braille	用盲字印
opponent	对抗的
perplex	困惑
justificative	起辩护作用的
exploration	探险
semimoist	半潮
septangular	七角
thermit	铝热剂
ornamental	装饰性
subacid	略带酸味的
gypsy	象吉普赛人
enphytotic	植物恒定流行病
contingently	临时
saceur	Commander
transmission	传动
un	Nationals
abstemiously	有节制
rudderless	无指导者的
settleable	会沉淀的
yonker	=younker
authority	权力
prickle	刺
crowned	有王冠的
solatia	solatinm的复数形式
protonation	质子化作用
bmoc	校内大人物
perversive	颠倒的
confirm	给……行按手礼
accusatorial	责问
dreamfully	常易梦见
regional	地域性地
malease	=malaise
slack	使松弛
heimisch	朴实的
vly	=vlaie
succedaneum	代理者
curiousness	好奇
hortensia	霍滕西亚
currently	普遍
bedge	标记
dr	分布式刷新
irritating	使愤怒
bid	吩咐
usafe	United
unmoral	不道德
atomistics	核子物理学
authoritarian	独裁的
tympanist	管弦乐的鼓手
husband	丈夫
slow	迟钝的
special	特殊的
ormuz	=Hormuz
trailerable	可放在拖车上载运的
indecorous	不合礼节
incentive	激励
illegibly	难读
unredeemable	不能赎回的
detergency	去垢力
hemiparetic	偏身轻瘫的
carnassial	食肉
smackhead	海洛因瘾君子
schoolyard	运动场
vcd	Disc
fusionism	联合主义
expansion	膨胀
circular	通知
justificatory	用以辩解
melanosome	黑素体
sexcentenary	六百年的
clean	使干净
juvenility	年轻
feminism	女权运动
mungarian	匈牙利人
misapprehend	误会
eucharistic	圣餐的
paniculated	圆锥花的
zipless	短暂而猛烈
isotactic	全同立构
fiume	阜姆(南斯拉夫西北部港市里耶卡
laxness	弛缓
editorialist	撰写社论者
monadism	单子论
pedal	踩……的踏板
hemiterpene	半松油精
vermifuge	驱虫的
earliest	早
louise	路易丝
unavoidable	不可避免
demonian	疯狂
contiguity	邻近
franchise	特权
dns	Server
puffy	膨胀的
unperishing	=immortal
selected	经由选择
alarmable	会被惊恐
magnitude	大小
texturize	=texture
ansate	有把手
cfs	feet
speedwalk	电动人行道
tosspot	酒徒
haemagglutinate	血细胞凝集
stand	台
pine	树木
ier	乘数寄存器
tau	希腊语的第十九个字母
holme	=holm
wrinkle	使皱
innocency	洁白
messianic	救世主似
dairen	Dalian
farinose	产粉
grand	豪华
penetrable	可穿透
tablet	拍纸簿
mirthful	愉快的
routh	丰富
extrapolability	凭已有资料进行推断的能力
analogously	类似地
gbs	Shaw
appealing	哀诉似
incubus	沉重的负担
clinquant	仿金箔
jittery	神经过敏的
undersea	海面下的
expectorant	化痰的
purposeful	有目的的
paesano	同胞
perceptibility	可感知
kicker	爱发牢骚的人
register	注册
validate	确认
ajc	Jockey
tritiated	含氚的
seriously	真诚
robotism	像机械人的行为
icy	盖着冰的
recalcitrant	顽抗者
coupon	息票
wolflike	狼一般的
towardly	适宜的
eurytopic	广适性的
conjuration	祈祷
drakestone	石片
monopropellant	单一组分的喷气和燃料
dependency	从属物
scotticism	苏格兰语风
stowaway	匿身处
spellican	=spillikin
pygidium	臀板
clinicopathologic	/
uniaxial	单轴晶体
sinter	烧结物
rbs	Royal
response	响应
beltsville	Small
untruss	使脱开
arthropod	节肢动物
tumour	肿块
mulla	毛拉
legatary	遗产承受人
legiron	脚镣
sapient	自以为聪明
chicalote	阔果蓟罂粟
juggle	耍弄
treacle	甜蜜
ata	Attachment
breadwinner	负担家计的人
pythiad	皮提亚德时期
whitehanded	两手雪白
rivalship	对抗
flocculent	覆以绒毛
fertilizable	可受精的
epileptoid	癫痫
pontiff	主教
aflatoxin	黄曲霉毒素
cuprous	一价铜
modacrylic	人造纤维之一种
unphysiological	生理上不健全
viscountcy	头衔等
assr	苏维埃社会主义自治共和国
redesign	重新设计
nosocomial	医院
undernourish	使吃不饱
biostrome	生物层
bivouacking	bivouac的现在时
openhearted	不隐瞒的
fogging	雾化
rustically	乡土气
fleckless	完美
heroon	庙形坟墓
thermosetting	热硬化性的
triclinic	三斜
subsea	海底的
gnosticism	诺斯替教
auditor	核数师
logos	理性
lollypop	糖果
switch	开关
linalool	芳樟醇
inconveniency	=inconvenience
osteological	骨学的
keltic	凯尔特族
typhogenic	引起斑疹伤寒的
cystine	胱氨酸
prattle	闲聊
tryout	预演
cornily	粗野
underseas	海底
kue	英文字母q
extractable	可拔出的
tentaculiferous	具触手的
isolead	curve等提前量曲线
schradan	八甲磷
dolman	女斗篷
unintelligent	缺乏才智
cranky	任性的
hydrofluoric	氢氟酸
goldbrick	称病
rsgb	Radio
buffo	滑稽的
catamnestic	诊后病历
uncorrupt	纯正的
break	折断
pollywog	首次越过赤道的海员
ratguard	板
paranoea	偏执狂
inflorescent	开花的
secretively	稳秘
semiskilled	半熟练的
sly	狡猾
executor	被指定遗嘱执行者
like	同样的人
quadruply	四倍地
transformation	转换
lecithin	卵磷脂
lambda	11个字
weather	经受风雨
vacillation	摇摆游移不定
venostasis	静脉郁滞
overwore	overwear的过去式
raven	掠夺
betelgeuse	猎户星座中的一等星
electrotypist	电铸术
malnutrition	营养不良
smoky	烟状的
whisk	迅速移动
meliaceous	楝科的
technology	工艺
gauchesco	加乌乔诗体的
pellucidly	易懂地
indistinction	不确定
susceptive	有接受力的
sebaceous	脂肪
frithstool	平安座
xylocarp	硬木质果树
anticlastic	互反
jag	戳
totipalmation	全蹼
scoresheet	记分单
founder	破坏
calcrete	钙质结砾岩
squamulose	有小鳞片
abducent	向外扩展的
declamatory	朗读式的
compartmental	区划的
confidently	信赖地
ultraviolation	紫外线辐射
hypnopaedic	睡眠教学法的
enclave	被包围的领土
phosphureted	与磷化合
furthermore	此外
voyageable	能航行的
undersexed	性欲淡泊的
yield	产量
stuggy	健壮的
infamy	声名狼藉
eulogia	圣餐
decasualize	减少临时工人
unfelt	无感情的
zigzag	曲折
maund	重量单位
extinguish	消灭
sequential	连续
rechristen	再次施洗礼
sauger	大眼鰤鲈
upriver	从上游
nightwork	夜间工作
unmelodious	音调不悦耳
reread	重读
snakewood	蛇纹树
blowzy	不整洁的
semicontinuous	断断续续的
vasculitic	血管炎
social	爱交际
welsh	不付赌金而溜掉
heterogametic	形成两种胚细胞的
seam	发生裂痕
vagarious	越出常规的
hygroscopic	吸湿的
patter	使发嗒嗒声
crabbed	难懂
bombload	飞机炸弹装载量
liquid	清澈
hyperacid	酸过多的
voodoo	施伏都巫术迷惑
housebroken	有礼貌的
carman	运货马车的车夫
c	C语言
decayed	烂了的
scarce	不充足的
algebraize	用代数解答
chatelain	城堡主
skirt	环绕
undulated	波形的
hydrochloric	盐酸的
fleuret	小花
unreason	无理性
mantelletta	无袖法衣
tyrannically	专横地
lousy	生虱
liquorish	美味
poetess	女诗人
menstruate	月经期间
genocidal	种族灭绝
diachylon	铅膏
diacritical	为区别
unlike	不相似
grave	严重的
pettifogging	欺骗
manipulator	操作者
naima	奈玛
execute	处死
shakeout	股票市场震动
outback	在内
contrariously	相反
turbofan	扇喷射
comments	注解
cyclostomatous	圆口动物
impressionistic	印象派的
celeb	名人
blesbuck	=blesbok
campanulaceous	风轮草属的
flexuose	弯曲的
slinky	偷偷摸摸
alcestis	阿尔刻提斯
essentiality	本质
broking	做经纪的
rampant	跛拱的
biliteral	由两个字母组成的
pursy	肥胖
dissolvent	有溶解力
agley	斜斜
armamentarium	全部设备
regnum	统治
azinphosmethyl	谷硫磷
endostea	endosteum的复数
jiminy	温和的惊讶
videogenic	适合电视
precolonial	殖民地时期前
eunomic	守法的
renitent	顽强的
register	寄存器
gastroscopy	胃镜检查法
tuffaceous	凝灰质
whimsical	古怪的
mesenchymatous	间叶细胞样的
exdividend	除般息地
westwood	美国著名游戏软件公司
bicorporal	有两个身体的
borough	自治的市镇
purl	金银丝
unsicker	靠不住
genuinely	诚实
anathemata	革出教门
packery	=packinghouse
artisan	工匠
eighthly	第八
archeozoic	太古生代
pumice	磨光
numerously	多数
shaven	削发
moslemic	伊斯兰教义
oppressively	沉重
areological	火星科学研究
fodder	饲料
austroasiatic	南亚语系
kiddywinkle	=kiddywink
pithless	无髓的
emanate	发散
sulphadiazine	磺胺嘧啶
neurotoxin	神经毒素
spark	发火花
rockered	圆底的
statutable	法令的
manipulable	可操纵自如的
cannibalize	调拨……的人员
incommunicative	不爱说话
amazonian	刚勇好战
coloratura	花腔音的
upya	操你妈
tetrastich	四行诗节
monorail	单轨铁路
rename	改名
abortively	流产地
fertilizable	可施肥的
stuffing	填塞料
redoubtable	可怕
phenylethylamine	乙胺
economist	经济学者
dyeline	重氮复印法
normally	通常地
tubal	输卵管的
acclamation	喝彩
pumiceous	象轻石的
degrading	不名誉
mutule	飞檐托块
someplace	在某处
acajou	桃花心木
duumvir	共同担任同一职务的两官吏之一人
unadaptable	不能改编
sidebums	鬓角
indocile	难驯服
essentiality	本性
collarless	无领的
outvote	以票数胜过
overdramatize	过分戏剧性地表达
antiterrorism	反恐怖主义
awane	减弱中
clavated	一端膨大
deflection	偏差
project	放映
keratoid	角状
chalklike	似白垩的
calculated	计算出
dprk	Democratic
distobuccal	远中颊的
hooker	渔船
textile	纺织品
spilosite	绿点板岩
convinced	深信的
plangent	轰鸣
nephrotic	肾病的
mystagogical	解释神秘的
gloam	薄暮
housewifery	家事
ambassadorial	大使
lyricize	写抒情诗
coarctate	压在一起
animality	动物界
condemned	被宣告有罪
cynosural	引人注目
ulterior	隐蔽的
federate	联合
diversion	娱乐
wholesale	批发的
equalitarian	平均主义
ergosome	多核蛋白体
presbytery	长老会辖区
baize	粗呢
footy	无足轻重的
destructuralize	拆开
illusory	虚假
reprehensible	应斥责
laminated	层积的
unmeditated	未预谋
iyft	信息随手可得
karachai	卡拉柴人
enshrine	铭记
arsenious	含砷的
midianite	米甸人的
impure	不纯的
banderilla	斗牛用的带有倒钩的短标枪
vtech	伟易达集团
perforce	必然
larn	学
spavined	跛的
inelasticity	无伸缩性
fast	耐久的
unfoiled	未被击退的
cankerworm	尺蠖
goalkeeper	守门员
tungusic	通古斯满语族
nocardia	土壤丝菌属
strictly	严格
latex	乳汁
cocker	溺爱
datto	菲律宾摩洛族之酋长
dynast	统治者
refrigerate	使清凉
sapped	受冰川作用侵蚀的
upbraiding	谴责的
aesthetics	美的哲学
feudally	如封建地
stalactical	钟乳石
topnotch	最高度
khud	绝壁
lipase	脂肪酶
crosswind	侧风
ceremony	典礼
wellsite	钡钙十字石
corporativism	=corporatism
salpingography	输卵管造影术
shivery	易碎成片状
protactinium	镤
imaginably	想象得出的
landsraad	立法会议
lye	碱液
birdcall	鸟叫声
sabot	木鞋
telocentric	具端着丝粒
tinsmith	洋铁匠
inlet	小港
mussily	乱七八糟
idle	浪费
smudge	污迹
static	静电噪声
auntie	姑妈
talc	用滑石粉处理
proletcult	无产阶级文化
atomarium	原子研究设备展览室
cocarboxylase	脱羧辅酶
nuraghe	古代塔状建筑物
papillary	乳头状突起的
female	柔弱的
fallow	潜伏发
inutterable	=unutterable
wishfully	希望
stress	压力
monchiquite	沸煌岩
anilin	苯胺的
sear	干枯
yap	废话
falconiform	隼形目
levitate	飘浮空中
wsb	工资稳定委员会
disciplinarian	训练的
glidingly	流畅地
one	pro
hematemesis	吐血
tubulate	制成管状
vicarial	代理教区牧师职务的
children	孩子们
littleness	些许
cassandra	卡珊德拉
chrysalis	茧
anestrous	不动情期
standard	规格
regimen	摄生法
pagandom	无宗教信仰的人们
preovulatory	排卵期前的
templar	圣堂武士
sultrily	酷热地
aggradation	沉积
coincident	一致
extramarital	私通
overchurched	设有过多教堂
nds	Services
effusive	流出
convention	协定
piss	撒尿弄湿
graniferous	结粒状之实
salient	凸角
mcpo	Petty
unburned	未燃
mound	护堤
kissableness	美丽而令人想吻的人
caragana	锦鸡儿
tinny	含锡
replay	重放
disobedience	违抗
gulosity	饕餮
some	有些
sorrowful	悲伤
sneak	暗中进行的
gherao	挟持雇主
vacate	空出
creamwove	米色布纹纸
yuchi	优奇人
supersubstantial	超实体的
unmerited	不配
procuratorial	代理人
irreclaimable	不能开垦
countermand	反对命令
still	静态图片
besot	使烂醉
drossy	碎屑的
skeletony	骨瘦如柴的
chloroethylene	氯乙烯
cheiromancy	=chiromancy
everlasting	耐用
prettiness	可爱
railway	铁路
balboa	巴拿马的银币
sore	痛心的
exactness	精确
wander	迷路
palmiped	蹼足
bill	议案
tripleheaded	有三个头
scape	景色"之义
unpersuaded	不被说服的
vespertilionine	蝙蝠科的
replace	替换
minorca	地中海西部岛屿
nllst	Library
fire	闪光
josh	无恶意的戏谑
conchae	贝壳状结构
force	强制
semiabstract	半抽象的
cubage	体积
bravely	勇敢
fid	厚片食物
thalassocrat	海上霸王
abmigration	反常迁徙
bandersnatch	行动粗鲁者
canadien	法裔加拿大人
indiscretionary	卤莽
homopolar	单极
vxd	Device
redistribution	重新分配
wizzled	干瘪的
baotou	包头
tinderbox	易燃物
ganglionic	神经节
geometrist	几何学家
intranquil	不安的
physiognomy	人相
prairillon	小草原
pondfish	池塘鱼
languishing	渴望的
fwpca	Federal
bfr	Run
replacement	移位
banausic	实用
otherworldly	修来世
haematogenous	生血的
redivious	复活的
dunghill	脏物
stormy	激烈
mhs	Service
septicaemic	败血病
fleetingly	飞快
laicize	凡人化
corrupt	堕落
flooding	变色
scoop	铲子
fauna	动物志
inboard	在向内
diopter	屈光度
mbfr	Balanced
torte	德国大蛋糕
scientifically	按科学的方法
rdc	District
nitty	多虱卵的
borrowed	借来的
bate	减弱
regionalize	分成地区
lex	法律
lilied	多百合花
jumbled	混乱的
venturesomely	卤莽地
distortedness	被曲解
rhinoscopy	照鼻镜检查
humous	腐殖土
geegee	马
arcaded	成为拱廊街道
lick	征服
playboy	花花公子
strophe	诗节
sedentariness	久坐
embrocate	涂擦药液
nes	别处不作说明
cardfile	卡片盒
title	资格
virilocal	居住在男方的
stabbing	伤感情的
suberic	软木的
pediococcus	足球菌
amaranth	紫红色
ceilinged	有天花板的
feculent	臭
ega	增强型图形适配器
horseless	自行推进的
bellicism	好战性
bulwark	防波堤
woody	木本的
effulgent	光辉灿烂的
plerocercoid	裂头蚴
lude	安眠酮
hydromel	蜂蜜酒
unreligious	与宗教无关
corel	加拿大Corel软件公司
gutta	滴
iadl	International
salvationist	救世军的
pledge	誓言
stony	无情的
unknown	不知道
braver	勇敢的
hatting	制帽
water	含水的
escapism	空想
kampala	坎帕拉
avulsed	被撕开的
recklinghausen	雷克林豪森
regalist	王权至上主义者
purchaseless	无紧缠力的
hotblood	热情者
purchaser	购买者
plump	扑通声
unambiguous	不含糊的
npv	present
maximum	最高的
impressive	给人深刻印象
ovolo	圆凸形线脚装饰
bough	大树枝
appetence	本能
tightfisted	吝啬
vulnerary	医治创伤
skilful	巧妙的
thermostable	耐热
giurgiu	朱尔朱
radiopacity	辐射不能透过
fleshy	肉质的
whereof	以什么
tributary	附庸的
intragalactic	银河系内
inferior	自卑的
bugs	疯狂
embryogenesis	胚胎发生
knockabout	喧闹的
stolidly	神经麻木
eared	有穗
girondist	党
talari	埃塞俄比亚元
impotence	无效
fisher	渔夫
utopiate	欣快剂
asepsis	无菌
shakily	不稳定地
cinquain	五个的一组
pilaster	壁柱
rented	租金
cocktail	开味食品
scot	分摊财政负担
adumbrative	暗示的
marshy	湿软
featherheaded	轻率的
latchstring	栓锁带
seedily	不体面地
circs	情况
instance	建议
humper	保险杆
alien	不同
chyack	=chiack
letdown	失望
hokey	虚情假意的
substance	实质
personalize	人格化
hypnopompic	半有意识状态的
introductive	前言
doing	活动
superhigh	超高
luddism	劳工运动
sunlit	被日光照射了的
micrograph	显微图
christianly	有基督徒性质
enlarging	扩大
profitability	收益性
mirable	美妙的
jiggered	''damned''
taa	Technical
vociferate	喊叫
overcaution	过分谨慎
baculine	棒的
tertio	第三
affect	影响
raiser	提出者
dally	玩弄
tap	轻打
excusably	可辩解
goldman	高曼
lean	倾斜
septuple	乘以七
puristical	用语简洁的
collocable	可组合的
trijugate	具三对羽片
preciously	昂贵
minification	缩率
lative	方向格
erotica	色情作品
contrived	做作的
secta	审理中的案件
zoetic	有生气
anuric	无尿的
trophoblast	滋养层
chou	甘蓝
recognition	识别
accustomed	通常
dunt	陶器的裂痕
transpire	泄露
ectozoic	体表寄生虫的
coiffeuse	女理发师
aerodynamics	气体力学
ccco	Objectors
unkennel	出洞
zanu	Zimbabwe
polarograph	极谱记录仪
mode	方式
postimpressionism	后期印象派/ist/9pEJstIm`preFEnIst/
rejuvenescent	返老还童的
deliberation	考虑
vitellin	卵黄磷蛋白
dominant	显性的
vasoactive	作用于血管
hitfest	有多次安打和跑垒的棒球比赛
acaleph	水母
kasbah	城
divorce	脱离
taproom	酒吧
gliding	滑行的
damned	糟透的
troop	多数
clabber	发酵奶
mohammedan	伊斯兰教的
carping	挑毛病
vaccine	牛痘
baseborn	庶生
fishwoman	女鱼贩
friendship	友好
legpuller	恶作剧者
saran	莎纶
cattalo	杂种牛
gurry	鱼下水
ovariectomize	切除……的卵巢
ade	果汁饮料
serific	制丝
tearaway	行为鲁莽
fsb	Front
holand	荷兰
mre	Master
calx	矿灰
crackpot	怪人
neoromanticism	新浪漫主义
deliberately	故意
handled	有把柄
hexameral	=hexamerous
webbing	结实的带状织物
gasworks	煤气厂
canulate	管状的
farmworker	雇农
endochondral	软骨内的
mow	刈
oppressive	难以忍受的
unreasonable	不切实际
swarthy	黑黝黝
unselfishness	慷慨
neutrodyne	中和接收法的
commit	答应负责
kris	波壮刃短剑
tetrapetalous	四花瓣
dragline	牵引绳索
magnetotactic	有磁趋向性的
soldiership	军事手腕
english	英格兰
flocculent	絮凝
pize	打
scholastic	学者的
monial	=mullion
wardenry	典狱长
smaltite	砷钴矿
belvedere	望景楼
billionaire	亿万富翁
certain	pro
plated	装甲
puppyish	小狗天性
soaraway	腾飞
ruhmkorff	伦可夫感应线圈
southpaw	用左手
seed	原由
extemporal	无准备
retinalite	蛇纹石
unissued	未发行
successive	连续的
kirghiz	吉尔吉斯语
radian	弧度
boise	博伊西
burthen	负荷
caecotomy	盲肠切开手术
nethermore	较低的
baneful	使人苦恼的
destruct	破坏
cinchona	金鸡纳树
acidic	酸的
ignorant	无知的
skyphone	空中电话
recapitulatory	着重阐述要点
eeoc	Opportunity
convolve	卷
phosphoric	含磷的
yuchi	优奇族
hypergolic	自燃
reaction	反动
sericulturist	养蚕业者
inartistic	非艺术
kraal	牛栏
sparkish	美男子般
volva	菌托
knowledgeble	博学的
groundless	没有理由的
chasseur	猎师
bottom	底
mediate	作为引起……的媒介
cleistogamous	闭花受精
garp	Global
wastepaper	废纸
stripy	有斑纹
pushing	有冲劲的
instant	速溶的
ideographic	表意字构成的
finely	细微地
ivorian	象牙海岸的
needlecraft	裁缝
rainbird	报雨鸟
hitlerite	希特勒主义者
level	使同等
planting	栽培
zodiacal	黄道带
surrey	萨里式游览马车
estrange	疏远
opsonin	调理素
augment	增加
piperaceous	胡椒科的
digitorium	手提键盘
kettle	鼓
diablo	一个著名游戏的名称
phospholipin	磷脂
spirochaetal	由螺旋体引起的
leachable	可滤去的
retinaculum	着粉腺
boa	女用毛皮
fibulae	搭扣
fluctuant	起伏
laevorotary	=laevorotatory
vulnerable	易受攻击
rainwater	软水
smokebell	灯罩
veda	吠陀经
draper	衣料织品商
starveling	挨饿的
polycystic	多囊
technicalization	技术化
didymous	成对
flaked	睡去的
vibrato	颤音
tritiated	含氚
prongy	有尖齿
par	标准的
tranquillizer	镇定剂
snye	支航道
thermal	热的
ms	Military
photographer	摄影师
uncivilized	未开化
forementioned	上述的
misanthropic	憎恶世人的
tyrolite	铜泡石
agonistic	论争的
chromoprotein	色蛋白
employment	雇用
mexico	墨西哥
recordation	记载
centigram	厘克
interfix	相关
hyperpyrexia	高烧
jokey	滑稽的
wizardly	神奇的
field	野外
fluty	似笛声的
napa	=nappa
rainless	无雨
saturnian	农神的
renominee	再次被提名者
mhg	Middle
natsopa	of
reinstitution	重新建立
pasteurism	巴氏杀菌理论
electrolysis	以电针除痣
break	突变
sjc	Supreme
eclipse	引起月蚀
yewen	用紫杉木做
infrangibility	不能破坏
inesculent	不可吃
vapor	使蒸发
topotype	地模标本
disciplined	遵守纪律
complementarity	补足
pelletize	把……制成丸
gallionic	不问事
syndrome	综合病症
unjustifiable	无法辩护
ceuca	Central
sanandaj	萨南达杰
exopoditic	外肢节
arrisways	斜
superabound	有余
liquid	液体
anion	阴离子
enfeoff	转让
sinistral	用左手的
castigatory	惩罚
path	小路
relatival	关系代名词
cannibalize	调拨人员
unread	没有人看
struck	受罢工影响
barnacles	眼镜
castalian	诗之泉的
epson	日本爱普生科技公司
phosphorolysis	磷酸解
cryptozoic	生于偏僻地区的
brimstony	似地狱的
vernal	春天发生的
collarless	无领
scottishry	苏格兰民族性
tarantula	狼蛛
photoelectrode	光电极
exception	除外
monotechnic	单科
communist	共产党员
distributively	分发
meliorable	可改进的
tensity	紧张
alod	=allodium
wae	无线应用环境
somniferous	使爱睡的
accomplishable	可达成
plywood	合板
outwent	outgo的过去式
yanomamo	雅诺马马人
incalculably	不可胜数地
drop	滴下
pacchionian	Pacchionian
nonboarding	不供膳宿的
venusian	金星的
butler	仆役长
qualify	具有资格
powerful	强大的
stentorian	声音洪亮
gumshoe	悄悄走
hound	使追逐
implausibility	难信的
dab	轻拍
foozle	笨拙地做
jumbotron	超大屏幕
foreordination	宿命
antipathic	反对倾向
chuckawalla	=chuckwalla
terminable	可终止的
stouthearted	大胆
outbound	开往外地的
trigeminal	三叉神经的
dab	涂
guyanese	圭亚那的
elevated	严肃的
pcav	Angular
ilk	相同的
crmp	Police
ketoglutarate	酮戊二酸盐
leukopoietic	白血球形成的
backing	赞助者
concentric	同中心
rda	推荐的日摄食量
cultipacker	碎土镇压器
cassis	产于欧洲的黑醋栗
castellar	似城堡
acoustics	声学
imaginatively	想象上地
economy	经济
maxi	长大衣
diastyle	长距列柱式的
church	教派
noisome	有毒的
potestas	字母的音位值
asthenic	虚弱的人
otolaryngology	耳鼻喉学
exit	退出
uplighter	向上的照明器
lounger	懒人
volitive	表示意志
baniyas	巴尼亚斯
aerosinusitis	高空鼻窦炎
ppm	每一分钟内可以打印的页数
genocidal	集团屠杀的
unsling	解开……的吊索
gradual	逐渐
coversed	sine
delicate	棘手的
thanatophidia	毒蛇
changeably	可变
willem	Silent)
saucer	碟子
scream	尖声叫
rightward	在右侧
supererogation	额外的努力
fissiparous	有分裂能力的
sapraemia	腐血症
ethiopia	埃塞俄比亚
globoid	球状体
semiprofessional	半职业性
length	长度
uncondescending	不屈尊的
phoebus	日神
separator	隔离物
divvy	分摊
causationist	相信宇宙因果律的人
dais	台
hydrastine	黄连碱
inapprehension	不能理解
incorporation	形成法人组织
pregenital	性器官发育前
accession	就职
cunctation	迟延
teacherless	无教师的
flimsy	不足信的
phenix	凤凰
naturopathic	自然疗法的
pronounced	显著的
causal	表示原因的词
iceman	送冰人
waltz	迫使前进
enterprise	计划
squawkbox	通话盒
tyre	轮胎
pathlet	小道
indisciplinable	难以驾驭的
fuck	诅咒
alarmedly	惊慌
sickly	有病的
johnsonian	约翰逊流派的
splodgy	有污垢的
clasp	钩
equipe	运动队及其装备
mirable	美妙
fame	传闻
yes	是
quercine	栎木制的
feastful	祝宴
saucerian	飞碟的
reconveyance	取回
hearsay	谣言
newsmaker	制造新闻的事件
flimflam	胡说的
plankton	浮游生物
pushily	粗鲁
metamorphism	变质
preferential	优先的
bighearted	慷慨的
inexplorable	无法探险的
screenwasher	挡风玻璃自动清洗器
nlaa	Legal
crankpin	曲柄针
flocculent	覆以绒毛的
appendiculate	附着的
goodman	主人
draughtsman	国际象棋的棋子
plashy	潮湿
drummer	旅行推销员
paraboloid	抛物面
radar	雷达
hygiene	卫生学
darkling	令人可怕的
viniferous	产葡萄酒
mirex	灭蚁灵
hesitation	踌躇
protect	/
thoroughly	十分地
naziism	德国国家社会主义
spile	木桩
ingenious	精制的
premature	太早的
manama	麦纳麦
firewater	火酒
tabby	起波纹
quip	嘲弄
ashes	灰烬
namaskar	=namaste
reimport	再输入
endobiotic	体内生的
subdivisible	可以细别的
nontelevised	不看电视的
diabetes	多尿症
osteological	学的
whizz	飕飕作声
brocaded	用浮雕法织锦的
gallimaufry	杂凑
polysaccharide	聚糖
prophet	预言者
rimless	无边的
nihilist	虚无主义者
deliquescence	溶解
trustless	不可靠的
slavery	束缚
transdisciplinary	跨学科的
curare	箭毒
banditti	匪徒
reradiate	再辐射
malimprinted	缺损印记的
trumpeter	喇叭手
potentiostatic	在稳压器控制下
rebel	反抗者
dilatorily	迟缓
linhay	外屋
waspish	易怒
console	安慰
ancon	肘托
epicurean	贪口福的
transgress	侵犯
blastomycetes	芽孢纲
commodity	日用品
folksay	俗话
recognizably	可被认识
agroindustry	农用工业
rectifiable	可纠正的
remanent	剩余的
milquetoast	胆小者
neapolitan	那不勒斯人的
mechlin	梅希林花边
stupid	乏味的
shamanize	信奉萨满教
obbligato	不可缺少
unambiguous	不含糊
leasehold	租赁物
floorboards	将汽车油门踏到底
avowable	可明言的
summarily	概要
gyropilot	自动操纵装置
apogean	远地点
singer	歌手
make	构造
annalistic	编年史的
smooth	无毛
altimetry	测高学
submundane	下
fist	握成拳
thrump	隆隆声
phototropy	光
phylogenic	系统发生的
blinking	一眨眼的
disparaging	轻视
treasonable	背叛
mx	Mexico
series	级数
qanat	坎儿井
milord	大人
energize	使活跃
wayzgoose	同欢
delible	可抹掉
incitement	刺激
dartboard	掷镖的圆靶
submuscular	肌肉下
frier	做油炸食品的人
hyaloid	透明的
dysuria	排尿困难
scot	苏格兰方言
sex	生殖器
restrictive	限制性
able	能干
asclepiadaceous	萝摩科的
cairn	石冢
connivance	假装不见
palpably	可触知
overdoor	装在门上方
traffic	运输
nondirective	非指示性
fos	free
donga	沟壑
krakatau	喀拉喀托火山
regardant	注视
syzygy	会合
variably	不定地
hoodlum	流氓
drift	漂流物
variational	变化
shone	shine的过去及过去分词
buddhistical	佛教
wheelman	舵手
perspicuously	显明地
scrofulous	堕落
cantabrigian	模仿英国
saturated	饱和
chime	打钟报时
hypaethral	无屋顶的
japanese	日本人
forecast	预想
resurrective	促成复活
scca	Car
tinny	似锡的
choreographist	舞蹈指挥
thermalize	热能化
smoke	烟幕
unequalable	敌不过
eutectoid	类低共熔体
specify	详细说明
herbartian	体系
lighthouseman	灯塔守望人
dishful	一碟量
conquian	=cooncan
lipographic	字母或词之脱漏
humorous	诙谐的
paleolith	旧石器
degression	渐减
prerecord	事先录音
proletarian	无产者
nonantagonistic	非对抗性
leno	纱罗织法
politically	政治上
meshy	象网
faultiness	可指责
darkle	呈显黑色
nightmarish	不愉快
dysthymia	心情恶劣
ascertainment	发现
mangosteen	倒捻子
grammatical	文法
whimper	哀诉
son	女婿
feodal	领地的
rubbly	碎石构成的
inextricably	逃不掉
chemitype	化学制版
heterograft	异种移植
exterior	外在
triturate	弄成粉
flambe	在火上烧过的食物
jeux	jeu的复数
shareable	可分享
africanist	非洲民族主义者
accentuation	重读
upcropping	出现
expressive	表达……
demosthenes	古代希腊的雄辩家
recoat	再涂在上面
datolite	硅灰硼石
accumbent	横卧的
gelid	极冷的
saccharimeter	糖量计
metascope	红外线显示器
fibular	腓骨
scythia	锡西厄
toner	硒鼓
headstrong	顽固
shari	莎丽
bargirl	酒吧女招待
vintage	收葡萄
sweatiness	汗流夹背
castrate	将去势
stellular	小星形的
bullshot	一种鸡尾酒
miniminded	愚蠢的
protuberance	隆起
wraac	Australian
winning	胜
spicily	下流
semitruck	=semitrailer
succory	菊苣
catchword	流行语
anharmonic	不和谐
urceolate	缸状
teetertotter	跷跷板
velamina	根被
ka	灵魂
launcher	发射台
pert	别致
calceolaria	蒲包草属
distichously	二列
shelter	保护
orthorhombic	正交的
stunsail	翼横帆
nutty	多坚果的
ichthyologic	鱼类学
denudate	赤裸
pmla	Publications
teleology	有目的
enquirer	寻问者
first	第一冠军
redescend	重新下来
troche	片剂
thessalonian	帖撒罗尼迦人
protrusive	推出
fugacity	无常
bland	冷漠
seeder	去核器
organism	有机体
stannous	含二价锡
penchant	趣味
intraswitch	交机内
inventress	女发明家
saxonism	源自盎格鲁撒克逊语
bedeswoman	救济院受施之女人
neighbouring	附近的
catenary	悬链线
mafic	铁镁质的
hairsbreadth	窄如发丝的
massotherapy	推拿疗法
chasseur	侍者
handlers	经理人
underpeopled	=underpopulated
necrotic	坏死
math	数学
bookcraft	著书工作
verbicidal	滥用词语的
piquant	开胃
facs	Fellow
cig	香烟
apostate	背教者
worsted	精纺
lawsuit	诉讼
synovial	含有滑液的
sialagogue	Ⅰ
sequitur	推断
caterwauling	叫春似
demilune	新月型之事物
darkling	黑暗
belletristic	文学研究
privately	秘密地
rubigo	铁丹
quercitol	环己五醇
abbreviative	缩略的
norge	=Norway
congenitally	天生
arrantly	众目昭彰
doorhead	门框上的横木
downer	镇定剂
cryptographical	密码地
slaver	垂涎
introduction	初步
extemporaneous	临时
corrective	矫正
rubbingstone	磨石
mmf	magnetomotive
wintertime	冬季
pshaw	哼声
candlewick	烛芯
unnumbered	数不清
bigeneric	属间杂交的
interpellant	质询者
darby	手铐
furphy	无稽之谈
tollgatherer	收税员
ritualize	奉行仪式主义
mirky	阴郁
pstn	switched
squamose	有鳞片
compute	用计算机计算
burnisher	研磨器
murmur	低声说
xanthous	黄色人种的
actinotherapy	射线疗法
transversion	转换
fagoting	抽纱法
damned	使人憎厌
rheumatic	风湿
customable	可课税的
clothes	被褥
conchoidal	贝壳状的
electrobiology	生物电学
fearfully	极
anticorrosive	防蚀的
bureaucratism	官僚作风
underneath	在下面
unwit	使精神错乱
unestablished	尚无成就
chafer	金龟子
slam	猛击
ezechiel	即Ezekiel
incorporable	可结合的
multiplepoinding	互相诉讼
for	适合于
terebinthinate	松脂的
fiery	炽热的
imaginative	想象的
victimless	无受害人
maluation	评价
pseudology	说谎
acinar	腺泡的
fascicle	簇
avion	军用飞机
chromatism	色差
thereto	另外
mammals	哺乳动物
whistleable	适合于用口哨吹的
urceolate	壶状的
deave	使听不见
scholastic	墨守成规者
endeavor	努力
puffery	吹捧的广告
fenderless	无防撞物
cherubim	小天使
skeptical	无神论
stager	演员
lamby	多毛如羊的
sukkur	苏库尔
maladaptive	不利于适应
malamute	爱斯基摩狗
comparatist	比较文学学者
campanology	铸钟术
eclectic	折衷的
helpfully	有用地
castellany	城主之阶级
aluminothermy	铝冶术
through	以
gbs	Bernard
autosomal	常染色体的
discover	发现
scholarly	学者气质
answer	答案
tristimulus	三刺激的
monophyllous	单叶的
lambkill	狭叶山月桂
photoheliograph	照相仪
interleaf	插入的空白纸
north	向北方
thermostable	热稳定
ranine	蛙科动物
monoblastic	单核细胞性
ambidexter	十分灵光的
antivenom	抗蛇毒素
devilish	如恶魔般
constabulary	警官的
since	后来
scum	将浮渣去除掉
whisk	飞奔
broadsheet	仅印一面的大幅纸张
worthful	可贵
sopapilla	油炸蜜糕
ganof	小偷
mucolytic	黏液溶解
rvsvp	请速答覆
talking	谈论
patter	念经
tuitional	讲授的
sapraemia	败血病
yow	惊讶时所发出的叫声
agential	代理商
wakeless	未受打扰
hello	哈罗
inspectress	女监督
snafu	大混乱的
tainture	污染
afloat	在海上的
awry	错误的
karass	情投意洽的一帮人
bam	欺骗
olla	什锦菜
unmeaning	无表情
hoarding	贮藏
libeler	污蔑者
nightshade	茄属植物
gentle	文雅
traffic	通行
neurology	神经学
contrail	飞行云
miniminded	没有头脑的
galwegian	加罗韦
glycolysis	醣酵解
haymaker	强击
highjacking	劫持
kmt	Tang
hernial	疝的
ajc	Club
gliding	滑顺的
cuss	咒骂
iodic	碘
emanate	放射
swag	水潭
deceleron	减速列翼
putrefiable	会腐烂的
proteid	蛋白质
familiarization	亲密
semiuncial	半恩锡尔字体的字母
telemedicine	远距离医学
tenuity	薄
whopping	巨大的
antelucan	黎明前的
freaky	畸形
bogey	可怕的人
mantissa	尾数
gameless	无猎物的
corresponding	通讯
perhydrol	强双氧水
assorted	多样混合的
matron	护土长
present	上演
dun	微暗的
lycurgus	莱克格斯
constant	不变
stroke	报时的钟声
brassart	铁护手
prevoyance	深谋远虑
smileless	严肃的
pyrometallurgy	热冶术
puddinghead	傻瓜
preclusive	除外的
iambi	短长格
clamour	叫喊
compare	比较
burglarproof	避盗的
etymon	字根
pestiferous	传播疾病
relier	信赖者
splendor	杰出
precolonial	沦为殖民地前的
sessile	无柄
milt	受精
desiccative	干燥剂
pop	爆开
altitude	高等
valiant	勇敢的
foppishly	艳冶地
sophisticate	诡辩
monochromical	单色
pseudoclassic	拟古
nongovernmental	非政治
earned	挣
sure	可靠
swami	偶像
impartial	公平
semisubterranean	半地下
causable	可致使发生
scummy	下流
gearless	无传动装置的
alliterative	头韵的
combust	燃烧
examinatorial	检查
place	寄予
frenzied	激怒
sociocentric	社会中心论的
moderatism	稳健主义
attention	注意
episodic	插话式
legacy	遗赠
prescient	预知
bemused	发呆的
accumbent	横卧
slob	粗俗汉
samp	玉米片
sulfur	硫磺
host	旅馆招待
brisk	活跃起来
denticulate	齿状的
leisure	悠闲
bulb	鳞茎
quilt	编辑
unveracious	假
reassert	重复主张
atomy	原子
dazzling	耀眼
ferreous	含铁的
druidic	督伊德教徒的
andorran	安道尔人
book	帐簿
velour	天鹅绒
botulinus	肉毒菌
dirtily	卑陋
ultradian	次昼夜
spencerian	斯宾塞哲学体系的
cherrywood	樱桃木
hospitaler	住院者
eximious	优良
stream	一股
bushy	灌木茂密的
aeriferous	送气
dogleg	弯曲如狗后腿
rigescent	僵化的
lemonlike	似柠檬
drainless	无排水设备
angulated	使成角
cobbly	畸岖的
alamode	上面加冰淇淋
idiorrhythmism	住在独自独自修行的僧侣寺院
violet	紫罗兰
twopence	两便士
fellow	同道的
oxacillin	新青二
living	生计
convict	罪犯
serpentine	蜿蜒
aimlessly	没目标
modena	深紫色
donor	原料物质
depletory	使空虚
culm	茎
idioglottic	自我语法
milligal	毫伽
lacerative	割碎
ingenuous	坦白
hardy	坚硬地
friendliness	亲切
tsarina	沙皇皇后
racketeer	敲诈者
wastebasket	把……放入废纸篓
span	跨距
acerous	无角
echinoid	海胆状
ryukyuan	琉球民族
atrium	心房
foxiness	有褐斑
disarmament	裁军
libratory	游移的
amimeche	Engineers
roily	焦急
jhvh	耶和华
benelux	全称
hubbub	吵闹声
fugleman	示范的人
capillary	毛细作用
floppily	叭塌叭塌响
flinty	冷酷
brayton	engine
translucent	半透明的
girth	周长
aftercrop	第二次的收获
pusillanimity	无气力
personal	容貌
hydrothoracic	水胸的
foliage	树叶
ungifted	无才华
meteor	大气现象
record	诉状
exploitative	开发资源
apoise	准备好
subadar	=subahdar
epicurean	美食家
adzuki	赤豆
joust	马上枪术比赛
vacuation	撤空
hyperbolize	对……大肆夸张
remoteness	遥远
algal	海藻的
elocutionary	演说法的
subseptate	具有不完全隔膜
creamware	奶油色陶器
limitless	无界限
metamorphism	变态
crytic	隐含的
enhalo	使生光彩
franchise	赋予公民权
aubrietia	南庭霁
sel	pro
compere	当……的主持人
goth	野蛮人
exaggerative	夸张的
rediscount	再打折扣
cement	粘牢
globality	全球性
biolysis	生物分解
edge	优势
royale	蛋糕饰块
brass	黄铜
blithering	唠叨不已的
worship	敬神
send	派遣
craftsman	工匠
druidess	女巫师
dps	per
undemanding	不严格
dichroscope	二色镜
bilocular	双房的
weather	受侵蚀
guesswork	臆测
flurry	慌张
coactivated	共激活的
mph	时速
vocationally	职业性地
moorish	摩尔人式
vapor	蒸发
nitride	氮化物
adjure	起誓
muscularity	强壮
fingerlike	指状的
antimagnetic	防磁的
skiagraphy	X
suggestible	耳根软
maynard	梅纳德
excuse	做为……的托辞
vinegrowing	葡萄栽培
cheering	欢呼
upperworks	干舷
frication	摩擦
eclectic	折衷学派的
unwooded	不长树木
idiocratically	特性
hugeness	广大
tradable	可贸易的
knowledgeable	知识渊博的
ribby	多罗纹
tgwu	Transport
hypopharyngoscope	崖咽视镜
stratigraphic	地层学的
pipeless	无管
stopgap	补缺者
claptrap	讨好的
wattle	枝条编成的篱笆
laxness	腹泻
noddie	傻瓜
scopy	能力的
cornucopian	丰富
educatory	教育上的
twiggy	小枝繁茂的
theft	偷窃的事例
millipede	倍足纲节动物
ensigncy	少尉官职
acting	起作用
hamitic	哈姆族的
wirepuller	幕后之操纵者
aries	白羊座
polygamous	一妻多夫的
voiturette	小型汽车
misspoken	misspeak的过去分词
sped	speed的过去式及过去分词
kogai	环境污染
deflorate	已开过花的
skillful	制作精巧的
cymagraph	反曲线轮廓勾划器
priapitis	阴茎炎
mingy	吝啬
sitten	sit的过去分词
grammatology	写作学
drossy	浮渣一样的
annunciate	告示
photocatalysis	光催化
hypomanic	轻度躁狂的
nonaddicting	不致瘾的
khedive	埃及总督
rightfully	正直
soviet	苏维埃的
dinkum	公平
motorship	内燃机船
prevenient	以前的
sockeroo	非常卓越的东西
nondurable	不耐用的
twiggy	小枝繁茂
jarful	一瓶之容量
bead	珠子
pinteresque	品特派风格
vociferously	吵闹地
separate	隔离
gain	增进
stupefactive	使失去知觉
floorer	难以置信的论据
veronica	通过Gopher使用的一种自动搜索服务
locution	独特的措辞
teetotalism	绝对禁酒
rennet	法国产的一种苹果
ticky	=tickey
motivator	促进因素
ctrl	计算机的Ctrl按键
gluttonous	暴食
seclusive	隐退性
resonantly	共鸣
trepanner	环截式采煤机
houseless	无房屋
unconquered	未克服
loris	懒猴属动物
elect	作出选择
diligently	勤勉
unitar	Institute
pittypat	轻快之劈啪声
achaean	亚该亚的
overtime	加班地
amnionic	有羊膜的
undersea	海面下
cog	欺骗
below	在页底
paling	围篱
censoriously	好批评
relieve	援救
galliambic	由两个抑扬格音步组成的
incalculably	无数地
drone	嗡嗡的声音
elementoid	元素状
answer	回答
distasteful	味道不佳的
trappean	暗色岩质的
tamber	音品
premaxillary	颌骨前
unlikeliness	不一样
pollution	污染
keerect	完全对头
ermentrude	厄门特鲁德
nascar	Stock
gothicist	遵奉哥特风格者
suppurative	化脓
intervalometer	定时曝光控制计
babylonish	巴比伦的
nlrb	Labor
wildebeest	羚羊的一种
pushball	推球
depravity	堕落
understate	保守地说
unsophistication	质朴
also	也
woadwaxen	greenweed
snazzy	时髦的
emancipatory	解放的
animative	使有生气
ostracism	贝壳放逐法
resumable	可恢复
shield	盾状物
fricassee	做炖肉丁
wight	人
phe	Health
degeneracy	退步
conceivably	令人信服
pecuniary	金钱上
geriatrist	老年病学者
ducky	极好
terminal	终端
photoproduct	光化产品
underwriting	保险业
inflexible	不屈挠的
hairpiece	假发
uplift	社会进步
bubonic	腹股沟腺炎
electrohydraulics	水中放电法
aldohexose	己醛醣
masticable	可咀嚼的
villain	恶根
rishi	富有灵感的诗人
metatherian	后哺乳下纲的
nomenclatorial	名称
parcelgilt	内表面镀金
unbe	使不复是
unifacial	单面精细加工的
energize	用力
superheater	过热设备
plutocrat	财阀
suggestibility	可教唆
castellar	似城堡的
conventionality	惯例
overwrite	推销佣金
dioestrous	间情期的
oracular	神谕
thievish	象窃贼的
monarchic	国王
functionalism	机能心理学
operation	手术
precess	使产生进动
upmost	最上
deadweight	自重
eely	易滑脱
gallnut	五倍子
kain	实物租税
tournament	比赛
allopatric	单独地发生的
mongrel	杂种
overemphasized	过份强调的
uproariously	吵闹地
flysheet	传单
elevated	严肃
cloak	斗蓬
demosthenes	德摩斯梯尼
reliquidate	再清算
corolline	花冠
sporadic	零星
hempen	大麻制
hearted	有……之心
molder	腐朽
hieroglyph	象形文字
plunderage	抢夺
effable	能被说出的
irreconcilable	不能协调
intraoperative	外科手术进行时发生的
ho	symb
acerb	酸涩的
triplane	三翼飞机
nonfiction	非小说的散文文学
trinal	三倍
mere	起码
indian	印度的
utilitarian	实利
plug	插销
recollected	镇定的
tough	耐
building	营造物
anzac	澳新军团士兵
eriophyllous	叶上有绒毛的
gnarl	使有节
klunky	破旧的
anagoge	对基督教等所作的神秘解释
misbegot	可鄙的
hydremic	稀血症
befitting	合适
ambisinister	两手均不灵活的
morphic	=morphological
midwifery	助产术
catastrophe	大祸
ile	"关系
houndstooth	犬牙织纹
inarguable	没有疑问
centrality	中心
sycophantic	说奉承话的
kitten	小猫
adduction	内收
tontru	南京同创信息产业集团公司
hum	嗡嗡声
araneiform	蜘蛛形的
counterargument	抗辩
headgear	帽子
adventurer	冒险家
ideational	构思的
truckle	用小脚轮使移动
currach	小型手推货车的一种
soar	高飞范围
dyeable	可染色
slow	迟钝
castiron	不屈
ramon	雷蒙
antiandrogen	抗雄激素物质
avt	value
claustrophobe	患幽闭恐怖症的人
detrital	由岩屑形成的
penchant	倾向
supinate	转动手使掌心向上
panoptic	展示全景
vouchsafe	赐予
brahman	婆罗门
lavish	过分丰富的
cole	小菜
laredo	拉雷多
numbered	时日无多的
senega	美远志
snuff	气息
hencoop	埘
papacy	罗马教皇职位
parcener	共同继承人
trackway	古道
bloodwort	血红酸模
gainfully	有利益地
polyonymous	多名的
tapestried	饰挂绣帷的
parallel	相似物
zygomorphic	两侧对称的
president	校长
columbite	钶铁矿
careworn	疲倦的
tuneable	可协调的
deuce	平手
rsd	Royal
unthought	未深思的
haemodynamic	血液动力的
figwort	玄参
heteropolar	异极的
iiion	伊利昂(小亚细亚西北部的古城特洛伊
eucharis	油加律属植物
paulin	防水帆布
melanism	黑变病
moppy	蓬乱的
dendrophilous	寄生树上的
revelation	揭露
lather	焦躁不安
pc	个人电脑
fecundate	使受孕
incomparably	无敌
forwearied	极疲倦的
solicitudinous	担忧
jest	俏皮话
brassy	铜头高尔夫球棍
bandbox	硬纸盒
tessular	=tesseral
expiree	满期出狱者
tapeta	的复数
versatile	多才多艺
bluejay	北美产的一种蓝色鸟
dexter	右侧的
hipshot	跛
circean	喀尔刻
betray	背叛
sketch	梗概
electrode	电极
pardoner	卖赦罪符者
prolific	大量繁殖
usrc	美国后备军
nuts	发狂的
vaquero	牧者
misfortune	灾祸
moralism	格言
bougainvillaea	九重葛
nervy	肌肉发达
reengineer	重新建造
junoesque	高贵优美的
peyotl	=peyote
idoneous	适用
nonagricultural	非农业
streptodornase	链道酶
imaginal	成虫的
subviral	亚病毒
businesslike	事务性的
nonnatural	违背自然的
acetic	醋的
mallemuck	大海鸟
bengalese	孟加拉人的
reedy	似笛声
unbacked	无靠背
stipule	托叶
unemployed	未被利用
dinette	小餐室
flq	Liberation
modificator	=modifier
sneak	暗中进行
aral	Sea
aniline	苯胺的
milchig	乳制的
sacchariferous	含糖
maroon	栗色的
masterpiece	杰作
antirust	防锈的
boche	德国人
oleo	人造奶酪
toothy	多齿
decently	端正
jaundice	由妒嫉引起的偏见的心理状态
ectophyte	外生植物
callable	可随时支取
mpeg	运动图像专家组
towboat	拖船
venereal	性病的
polak	波兰语
filter	渗透
chirpily	嚓嚓叫
bessemerize	用酸性转炉法吹炼
suggestion	微量
slatted	覆有板条
overknee	过膝的
spaceman	宇宙人
alcoholize	变成酒精
recorder	记录员
banjo	班卓琴
hyperacid	胃酸过多
assault	攻击
dislikable	使人厌恶的
bankroll	资金
pledgor	典押人
revolve	循环出现
disorder	无秩序状态
prepared	准备好
worm	蠕行
yogini	瑜珈女修行者
partner	与……合伙
uninvited	未经请求的
reflourish	复活
subornative	教唆
semifinished	经轧制的
sycophant	拍马的
scrap	零碎的
uncannily	神秘
papistical	天主教
warily	警惕地
heliotactic	背日性
inferior	差的
boskage	丛林
ioc	国际奥林匹克委员会
mechanistic	机械论
polygynous	一夫多妻的
morosely	愁眉苦脸
tension	使紧张
trainload	装载量
jostle	推
kylie	回飞棒的一种
unforested	未植林
pullulate	成长
myricin	软脂酸蜂酯
ordinate	纵线
surfing	冲浪游戏
preceptive	好教训人的
grouchy	不高兴的
nimonic	尼孟合金
value	重视
eyeblack	睫毛膏
catfoot	偷偷地走
issuable	可提出抗辩
corticated	有树皮的
panleucopenia	猫肠炎
sensoria	感觉中枢
dunnage	手提物品
nimes	尼姆
suicidal	自杀
transpire	发生
thioarsenate	硫代砷酸盐
cultivar	栽培变种
spectrophosphorimeter	`spektrEJ9fCsfE`rImItE/
unreachable	及不到
hathoric	爱神哈索尔
polite	有教养的
overspread	扩张
intervale	丘陵间低
glucinum	铍
wfp	World
doughhead	面包师
disband	解散
laminae	薄片
ambergris	龙涎香
uncharming	可厌的
homozygously	同型结合地
spermatic	精巢的
dinge	黑人
junkerism	德国贵族地主之精神或政策
foziness	愚笨
inquietly	不安地
punic	迦古太基语
eruditely	博学
reflected	自他人
artificer	技工
duodecimal	十二进位
hyalogen	透明蛋白原
godship	神性
alchemically	炼金术
candidly	坦白地
bidentate	有二齿的
spcc	英国防止儿童虐待协会
meridian	全盛时期的
patronage	光顾
lunatic	狂人
slicken	光滑的
zanu	津巴布韦非洲民族联盟
donkeyish	顽固的
leukemoid	似白血病
amply	详细
brotherly	充满情谊
proruption	隆起
stripy	有条纹
wether	阉羊
red	红色
granuloblast	成髓细胞
provide	规定
horsewhip	马鞭
spotter	私人侦探
betacism	v
call	号召
hypothetical	假设
neuropterous	脉翅目
bubonic	腹股沟腺炎的
fitter	胜任的
venery	性欲
medical	医学的
disgustful	深恶痛绝
rainbow	幻想
determined	坚决
waxen	蜡
spat	争吵
swimming	会游泳
ace	Europe
specky	有斑点的
blivit	乱七八糟的东西
quince	温柏
resentful	愤慨
arthurian	亚瑟王
valvate	有阀门的
chickee	棕榈叶顶棚屋
allonym	假托伪名
semistagnation	半停滞状态
myocarditis	心肌炎
stenotype	按音速记
retail	零售
solitaire	单粒宝石
enwrap	包围
allocable	可分配的
multiparous	多产
fabular	寓言
transmigrant	移居的
speckless	无瑕疵
invalid	病人
struggling	奋斗的
max	Max
najaf	纳贾夫
deactivate	复员
hemiplegia	偏瘫
necessitarian	必然论
cyc	周期
hyperspherical	超球面的
gallo	法国的
trochilic	旋转机械运动
capitalize	以大写字母写
whoop	叫喊
bacteremically	菌血症地
trockenbeerenauslese	特罗肯比勒瑙斯利泽酒
ungrounded	无稽的
broadcaster	撒播物
crunkle	起皱
unpriestly	非教士
gag	箝制言论
highgate	Cemetery
tartarous	含酒石的
lousiness	不清洁
priscan	古代存在的
manoeuvre	策略
ebb	衰退
enslavement	奴役
constitutive	构成
smooth	一块平
misplace	放错地方
roentgenopaque	X光透不过去
jins	需监管的青少年
erda	Administration
lampion	彩色灯
proudhonism	蒲鲁东的学说
unprevailing	不流行的
tannery	硝皮厂
distiller	蒸馏酒者
infanticipate	待产
tauntingly	嘲骂
tedious	沉闷
shortcoming	短处
gradatim	逐步地
estuary	河口
desideratum	迫切需要之物
flooding	产后出血
ironize	使具讽刺意味
meaning	意味深长
java	爪哇
incorporative	有结合倾向的
exhausted	疲惫的
cell	细胞
dolt	笨蛋
chamber	议院
deepfry	油炸
flattering	奉承
tetrapolis	四城镇行政区
psf	per
rheostat	可变电阻器
phytochemical	植物化学的
phleboid	静脉
complacence	n
klamath	克拉马斯河
methylate	使甲基化
fasten	使固定
pretone	重读音节前的音节
insistence	坚决主张
luteal	黄体
loam	肥土
shuttle	航天飞机
spirilla	螺旋状菌属
blackleggery	拒绝罢工
deintegro	再
irc	Relay
guttate	滴状的
saltireways	成X形地
amphistylar	前后两排柱而两边无柱的的
colic	疝气
airplane	飞机
puff	吹嘘
overmodest	过分羞怯
holophote	全光反射装置
synergetic	协同作用的
thin	淡
insouciant	漠不关心的
budless	无芽
hieromonk	身兼祭司之僧侣
sclc	Leadership
fat	Table
mild	适度的
fragmentized	破片的
espadrille	登山帆布鞋
quadrantal	四分仪
chekhovian	契可夫式的
egregious	惊人的
controvert	辩论
destructible	易毁坏的
clone	克隆
devoutness	朝拜
tumefy	隆起
trivalve	三瓣的
optimism	乐观主义
decide	判决
torpedo	油井爆破筒
teknonymy	亲从子名制
euryphagous	广食性
grimness	严峻
tenfold	十倍
roose	赞美
uppermost	在最上
crossband	横条
deistic	自然神论的
docile	听话
failingly	似将断绝
affluent	丰富的
strophoid	环索线
trucker	卡车运输者
yike	打架
following	下列各项
hybridoma	杂种细胞
mideast	=Middle
palliation	减轻
relievedly	宽慰地
cagey	精明
carnie	游乐场
vs	对
miladi	时髦妇女
psychologue	=psychologist
suspense	悬而不决
plumicorn	耳状羽
horner	角商
volume	大量
menstruous	月经来潮的
temporary	临时
parturient	临产
bewitchingly	迷人地
shudder	战栗
equably	稳定地
ministrant	辅佐者的
torques	颈四周的彩色项毛圈
chatterbox	唠叨的人
schizophrene	精神分裂症患者
likely	可靠的
kinematically	运动学上地
brace	支住
tortile	扭转的
extracranial	颅外
caterwauling	哀诉声
uninhabited	无人居住
workroom	工作室
forepassed	既往
hypoparathyroidism	甲状旁腺功能减退
galvanoscopy	电流检查
argentine	银色素
mortuary	埋葬死人的
wobbler	晃晃摇摇的人
footpath	人行道
condemnatory	处罚的
nacreous	真珠质的
shave	剃
desirable	值得要的
powwow	用巫术医治
informidable	不可怕
dissimilitude	相异
favonian	吉祥的
apathetic	无动于衷的
wise	英明的
scoopy	汤匙式
judaeophobia	对犹太人的憎恨
complaint	疾病
doubled	两倍
micrococcal	微球菌引起的
egoistical	自我中心
orangism	橙带党主义
methodist	卫理公会教派的
agravic	无重力区的
diacid	二价酸的
mut	傻瓜
quadrangle	方庭
cagy	谨慎
jazziness	爵士
cogently	痛切地
baggys	袋式冲浪游泳裤
triene	三烯
fateful	宿命的
patentor	专利权许可者
sponsorial	主办者
topknot	鸟的冠毛
grammalogue	用简单记号表示的字
svga	超级视频图形阵列
fideicommissary	遗嘱中将部分财产赠予第三者的
plateful	满盘
girly	像少女
bitterish	稍苦的
gynandromorph	两性体
irreclaimable	不可矫正
misbegot	可鄙
aleak	湿气
chrysalis	任何在形成中而尚未至完全成熟阶段的事物
roseate	红润的
spiny	多剌
grunge	蹩脚货
bossism	头领的支配
zealotic	热心
quasimodo	Sunday
actinometer	暴光计
daybook	交易日记帐
basaltoid	像玄武岩
endothermic	温血
anaplastic	还原成形术的
maladjustive	引起失调
calfbound	用小牛皮作封面的
gentlemanly	绅士派头的
quadratic	二次
stand	看台
furthersome	有利
creeper	爬行者
uhf	Frequency
easternmost	最东部
cushy	容易
distraint	扣押
statesmanlike	有政治家风格的
palpal	须肢的
intromittent	插入的
kudos	声誉
heel	踵
encyclopedist	百科全书编纂者
greenleek	澳大利亚绿鹦鹉
spermous	似精子的
exumbrella	上伞
narcotine	那可汀
codpiece	男裤前面的褶
explicit	直接付款的
integrate	结合
fussily	无事空扰
briery	多刺
drainless	取用不竭
capstone	压顶石
migrate	使移居
culverin	一种重炮
beachcomber	海岸巨浪
quadripartition	分成四部份
usafe	美国驻欧洲空军
gasometry	气体的计量
monoestrous	一次发情期的
leary	猜疑
recollection	回忆
retired	退休
runabout	流浪的
mobile	易变的
darkly	暗黑
batsman	击球手
gnomology	箴言集
farrandly	愉快地
enteropathogenic	致肠病的:
igneous	似火
neutral	中立
slot	水沟
forestall	行动
imagism	意象派
cryptographic	用密码写
seronegative	血清反应阴性的
rapprochement	亲善
bellpull	铃扣
platelet	小盘
veni	恺撒大帝
coprophilous	生长在粪便上的
supine	掌心向上的
malacostracan	软甲亚纲
aloof	冷淡
prythee	请
ladder	装设梯子
desubstantiate	使失去实质
wormwood	苦艾
detector	探测器
ring	敲钟
triskelion	三曲枝图
run	奔
academy	研究院
ripsnort	喧闹地沿……而去
logaoedic	由混合韵律组成的
incubate	孵卵
bpd	桶[日
dextrocularity	惯用右眼
megajet	等巨型喷气式飞机
carbonium	带正电之有机离子
ossification	僵化
cristate	有鸡冠状突起
parentheses	圆括号
allele	等位基因
septifragal	室轴开裂
america	美洲
teepee	美国印第安人的圆锥形帐篷
backscattering	后向散射
canonical	规范的
tournois	图尔城铸造
hiragana	平假名
dodecastyle	十二柱式
muster	样品
unsccur	on
vasculitis	脉管炎
barycenter	质心
backwind	操使风向下风处
chart	图表
fleam	放血针
minicam	携带式电子摄像机
iaea	Atomic
by	依据
lander	着陆者
kurbash	鞭打
zona	带状疮疹
globoid	略成球状的
sedimentable	可沉积
coterminal	共终端的
dyspepsia	消化不良
lmg	machine
pollack	青鳕
pandit	梵学家
causey	人行道
orthognathous	直颌
inequilaterally	不等侧地
creedal	信条的
tsugaru	Strait津轻海峡
missiology	传教学
immutability	不变性
waygoing	动身
sedimentologic	沉积学的
mvd	Del
saponated	用皂处理过的
pennyworth	一便士的价钱
unstring	使神经衰弱
urinose	含尿
experimentation	实验法
sciential	有学识
singly	单独
founder	使沉没
run	融化
indicatory	指示的
feracious	多产的
protoactinium	镤
distillable	可由蒸馏而得的
consistent	一致
stucco	装饰用的灰泥
sulfatase	=sulphatase
dall	sheep
itinerate	巡回
fissile	分裂性
signatureless	未签名
late	晚
golgotha	墓
mannerism	特殊习惯
producer	制作者
premix	预混合料
bluefish	竹荚鱼类
bloat	得意
irreverence	不尊敬
bludgeon	大头棒
raf	Air
inferior	劣等的
superheat	使过热
autocatalysis	自身催化
surge	汹涌
milestone	转折点
vergilian	弗吉尔之诗的
theonomous	由上帝统治
applecart	苹果车
dendrophile	爱树者
flaunty	虚华的
omnicompetent	有全权
moralism	道德准则
terminological	专门名词的
entad	向内
kedgeree	欧洲烩饭的一种
ironmaster	铁工厂厂长
cyclopedic	广泛的
classic	杰作
unfathomable	深不可测
gaberdine	工作服
worldful	庞大数量
kiloliter	千升
quintessential	精萃的
incumbency	压
awry	歪斜地
buccaneering	海盗行为
sleepwear	睡衣裤
outriggered	装有舷外支架
appellation	名称
socialize	使社会化
talcous	含滑石的
it	它
transit	转变
callous	起老茧的
noncampus	不在固定校舍上课
powerfully	强大
tricentennial	三百周年纪念的
remotely	遥远地
superfusate	浇注液
empress	极有权力的女人
crested	有纹章
disorder	使失调
sartorial	缝纫的
cribber	作弊者
illusage	虐待
stinking	臭
misshapen	畸形
dartist	玩掷镖游戏者
carrefour	叉路
adrift	漂泊的
exaggerative	夸大的
duodenary	十二进位
demoralization	道德败坏
ovine	绵羊
interspace	占据……之间
heirless	无后嗣的
urbanize	使文雅
fatherhood	父权
incurvate	内曲的
entoparasite	=endoparasite
devereux	Robert德弗罗
solstice	至点
patriate	把修改
alsoran	失败者
wedgie	楔形后跟的女鞋
waveoff	复飞
prehistoric	陈旧
tympanic	鼓膜
uninventive	非发明
babbler	说话模糊不清者
hemodynamic	血液动力学
ataxia	运动性共济失调
oligocarpous	果实不多
ornamental	观赏植物
softheaded	愚蠢
pig	贪婪地吃
flurry	阵风
modeless	非模态的
acrimonious	严厉的
monopodium	单轴
rashness	不瞻前顾后
aeroballistics	航空弹道学
tinker	修补匠
twitch	骤然一抽
edwardian	爱德华七世时代的人
pathetically	哀婉动人的
rsj	I型钢
surprisal	惊异
swanky	活跃的帅小伙子
reviviscent	复生的
toboggan	急剧下降
fiducial	信托的
sitting	开会
kurta	无领长袖衬衫
haemocoele	节足动物的血管体腔
unsuspicious	无猜疑的
fractography	金属断面的显微镜观察
innumerable	无数
abysmal	深不可测的
bemaul	严重打伤
resentful	愤慨的
irritant	刺激的
annuation	周年变异
colleague	同事
hospitality	宜人
dystopian	反面假想国
physicist	唯物论者
rehearse	作假
pascual	长在牧场
nupe	Union
zymurgy	酿造学
buckle	带扣
sickle	镰刀
rotatory	回转
slopwork	草率的工作
oligotrophic	贫营养的
fmc	Commission联邦海事委员会
slash	严历批评
mariolatrous	崇拜圣母马利亚的
hydropsy	水肿病
nte	Teacher
surveillant	监视的
assiduously	恳切地
exultancy	=exultation
dronish	混日子
phlogistic	热素的
griseofulvin	灰黄霉素
offramp	驶出匝道
aaup	American
via	经
irma	厄玛
pyramidal	金字塔形的
juvenal	雏鸟
umbral	有荫影的
fraudulency	骗诈
sphere	领域
transit	通行
whist	无声
downloadable	可下载的
overfly	飞跃
faconne	有细花纹
triumvir	三执政官之一人
unusual	不平常的
abortive	中断
description	记述
variant	不同的
blackart	妖术
diathermancy	透热性
exhaust	不会枯竭的
assembly	集会
franco	免费的
afeared	恐惧的
lumme	哎呀
acidfast	抗酸的
featly	整洁的
mansion	公寓
pestiferous	传播疾病的
shrilly	刺耳地
thoughtfully	思虑
incondite	结构拙劣的
potent	有效的
delicate	精密的
inattentive	疏忽
lasso	拉拢
icky	过分甜
mind	照看
fraught	充满……
poor	乏味
unprincely	非王侯
defoliator	食叶之昆虫
sassenach	英格兰人
nuclear	核
numerous	无数
hardly	严厉的
winnower	扬谷者
trisyllabic	三音节
whipper	抽打者
monotrichous	单鞭毛
floristry	花卉栽培技术
syncromesh	=synchromesh
bugger	同性恋者
resinous	用树脂做的
jivaro	黑瓦洛人
paesano	同国人
sensitiser	=sensitizer
rummily	奇妙地
underplay	对……轻描淡写
homochronous	同龄发生
augean	Augeas王的
ingrowing	向内生长
sebacic	由癸二酸衍生
parotic	耳旁的
cosmogony	宇宙进化论
vernal	春天
heavenly	极优美的
injury	伤害
railcar	有轨车
oppressive	沉重的
auximone	植物激长素
stainless	无瑕疵
darch	architecture
vrille	旋转
disciplinarian	厉行纪律的人
printing	印刷
seedtime	发展阶段
armguard	护手
turnside	眩晕
agnostic	不可知论者
guile	狡诈
glandulous	腺状的
tracheoesophageal	气管食管
waif	无主物
symptomatic	征兆
sundries	杂事
luciferase	荧光素酶
adrenalize	刺激
loanshift	字
disspirit	=dispirit
farcy	皮疽病
